ほっきがい	北寄貝	名詞	
せきちょうはく	石勺柏	名詞	
もみじがさ	紅葉傘	名詞	
とうみょう	豆苗	名詞	
かんらん	甘藍	名詞	
たまな	玉菜	名詞	
ちしゃ	萵苣	名詞	
ちさ	萵苣	名詞	
ようすう	四葉	名詞	
かがふと	加賀太	名詞	
まるなす	丸茄子	名詞	
せんじゅねぎ	千住葱	名詞	
くじょうふと	九条太	名詞	
くじょうほそ	九条細	名詞	
こしづ	越津	名詞	
こうけい	高系	名詞	
やまかわむらさき	山川紫	名詞	
べにあか	紅赤	名詞	
こうさい	香菜	名詞	
しゃんつぁい	香菜	名詞	
こりあんだー	香菜	名詞	
くうしんさい	空芯菜	名詞	
くうしんさい	空心菜	名詞	
ようさい	蕹菜	名詞	
とんつぁい	通菜	名詞	
あさがおな	朝顔菜	名詞	
ちゃうかんつぉい	抽筋菜	名詞	
つるむらさき	蔓紫	名詞	
むーあるつぁい	木耳菜	名詞	
さーんちょい	潺菜	名詞	
さやいんげん	莢隠元	名詞	
まめめいげつ	豆名月	名詞	
にんにく	蒜	名詞	
らっきょう	辣韮	名詞	
ほうれんそう	菠薐草	名詞	
ぶろっこりー	緑花野菜	名詞	
ぶろっこりー	芽花野菜	名詞	
みどりはなやさい	緑花野菜	名詞	
めはなやさい	芽花野菜	名詞	
はなやさい	花野菜	名詞	
かりふらわー	花野菜	名詞	
ゆりね	百合根	名詞	
おかひじき	陸鹿尾菜	名詞	
おかひじき	陸羊栖菜	名詞	
ひじき	鹿尾菜	名詞	
ひじき	羊栖菜	名詞	
おかひじき	陸ひじき	名詞	
ちょろぎ	草石蚕	名詞	
ちょろぎ	丁呂木	名詞	
ちょろぎ	丁梠木	名詞	
ちょろぎ	長老木	名詞	
ちょろぎ	長老喜	名詞	
ちょろぎ	長老貴	名詞	
ちょろぎ	千代呂木	名詞	
ちょろぎ	朝露葱	名詞	
じゅんさい	蓴菜	名詞	
ぬなは	沼縄	名詞	
くわい	慈姑	名詞	
きんじそう	金時草	名詞	
あんほるつぁい	紅鳳菜	名詞	
すいぜんじな	水前寺菜	名詞	
いせいも	伊勢芋	名詞	
しょよ	薯預	名詞	
たんばいも	丹波芋	名詞	
にょほう	女峰	名詞	
ほうこう	宝交	名詞	
はなほ	花穂	名詞	
はなほじそ	花穂紫蘇	名詞	
ほじぞ	穂紫蘇	名詞	
ねわさび	根山葵	名詞	
あおおに	青オニ	名詞	
うまじむらのうきょう	馬路村農協	名詞	
きおに	黄オニ	名詞	
つつみな	包菜	名詞	
かんこ	寒子	名詞	
はるこ	春子	名詞	
あきこ	秋子	名詞	
つゆこ	梅雨子	名詞	
ふじこ	藤子	名詞	
どんこ	冬菇	名詞	
こうこ	香菇	名詞	
こうしん	香信	名詞	
こうしん	香蕈	名詞	
てんぱく	天白	名詞	
はなどんこ	花冬菇	名詞	
ちゃばな	茶花	名詞	
ちゃより	茶撰	名詞	
しんかん	信貫	名詞	
おおとび	大飛	名詞	
なばし	茸師	名詞	
なば	茸	名詞	
おさ	褶	名詞	
だいこんな	大根菜	名詞	
えごま	荏胡麻	名詞	
じゃん	醤	名詞	
とうばんじゃん	豆板醤	名詞	
とうち	豆鼓	名詞	
とうちじゃん	豆鼓醤	名詞	
てんめんじゃん	甜麺醤	名詞	
まーぼー	麻婆	名詞	
まーらー	麻辣	名詞	
まーうぇい	麻味	名詞	
らーうぇい	辣味	名詞	
まみ	麻味	名詞	
らつみ	辣味	名詞	
ささげ	大角豆	名詞	
さんどまめ	三度豆	名詞	
さやえんどう	莢豌豆	名詞	
