じゃん	醤	名詞	
とうばんじゃん	豆板醤	名詞	
とうち	豆豉	名詞	
とうちじゃん	豆鼓醤	名詞	
てんめんじゃん	甜麺醤	名詞	
まーぼー	麻婆	名詞	
まーぼーなす	麻婆茄子	名詞	
まーぼーなす	魚香茄子	名詞	
まーぼーなす	ユーシアンチエズ	名詞	
ゆーしあんちえず	魚香茄子	名詞	
まーぼーはるさめ	麻婆春雨	名詞	
まーぼーはるさめ	螞蟻上樹	名詞	
まーぼーはるさめ	マーイーシャンシュ	名詞	
まーいーしゃんしゅ	螞蟻上樹	名詞	
まーらー	麻辣	名詞	
まーうぇい	麻味	名詞	
らーうぇい	辣味	名詞	
まみ	麻味	名詞	
らつみ	辣味	名詞	
かれー	咖喱	名詞	
かりー	咖喱	名詞	
たつののとき	龍野乃刻	名詞	ヒガシマル醤油
ひがしまるしょうゆ	ヒガシマル醤油	名詞	ヒガシマル醤油
おんらいそー	鳳梨酥	名詞	台湾のお菓子
ちゃわん	茶椀	名刺	木製品
おちゃわん	お茶椀	名刺	木製品
とうべい	豆酩	名詞	
どうばんじゃん	豆板醤	名詞	
ぴーしぇん	郫県	名詞	
ぴーけん	郫県	名詞	
ちょうてんらーじゃお	朝天辣椒	名詞	
ちょうてんがんしんじゃお	朝天干辛椒	名詞	
めかぶ	和布蕪	名詞	

