あるてん	アル添	名詞	
きだる	木樽	名詞	
じこみ	仕込み	名詞	
きだるじこみ	木樽仕込み	名詞	
とくせん	特撰	名詞	
じょうせん	上撰	名詞	
なまちょぞうしゅ	生貯蔵酒	名詞	
こもかぶり	菰冠	名詞	
つぼづめ	壺詰	名詞	
こもかぶりつぼづめ	菰冠壺詰	名詞	
こもだる	菰樽	名詞	
おみき	御神酒	名詞	
けいせん	桂撰	名詞	
きょくせん	旭扇	固有名詞	あさ開
あさびらき	あさ開	固有名詞	あさ開
なんぶとうじ	南部杜氏	固有名詞	あさ開
ゆきわたり	雪渡り	固有名詞	あさ開
げんぞう	源三	固有名詞	あさ開
ゆめあかり	夢灯り	固有名詞	あさ開
けんらんづくり	絢爛造り	固有名詞	あさ開
でんしょうづくり	伝承造り	固有名詞	あさ開
だいぎんじょうらいと	大吟醸ライト	固有名詞	あさ開
みずのおう	水の王	固有名詞	あさ開
せいれい	清麗	固有名詞	あさ開
すいじん	水神	固有名詞	あさ開
えいかん	栄冠	固有名詞	あさ開
なまかん	生缶	固有名詞	あさ開
だいはんじょう	大繁盛	固有名詞	あさ開
しこみうた	仕込み唄	固有名詞	あさ開
ふるさとのやまにむいて	ふるさとの山に向ひて	固有名詞	あさ開
ふるさとのやまにむひて	ふるさとの山に向ひて	固有名詞	あさ開
やまのきぶどう	山のきぶどう	固有名詞	あさ開
やまのきぶどうしゅ	山のきぶどう酒	固有名詞	あさ開
うめかのん	梅花音	固有名詞	あさ開
りんごのおさけ	林檎のお酒	固有名詞	あさ開
らふらんすのおさけ	ラ・フランスのお酒	固有名詞	あさ開
きくまさむね	菊正宗	名詞	菊正宗
