あまず	甘酢	名詞	酢0.5+砂糖0.167+醤油0.333
さんはいす	三杯酢	名詞	酢0.333+醤油0.333+味醂0.333
さんばいす	三杯酢	名詞	酢0.333+醤油0.333+味醂0.333
す	醋	名詞	
す	酢	名詞	
すしず	寿司酢	名詞	
すしず	鮨酢	名詞	
とさず	土佐酢	名詞	
にはいす	二杯酢	名詞	酢0.5+醤油0.5
にばいす	二杯酢	名詞	酢0.5+醤油0.5
ぽんず	ぽん酢	名詞	
ばるさみこす	バルサミコ酢	名詞	
わいんびねがー	ワインビネガー	名詞	
しょくす	食酢	名詞	
じょうぞうす	醸造酢	名詞	
こくもつす	穀物酢	名詞	
よねず	米酢	名詞	
こめす	米酢	名詞	
よねす	米酢	名詞	
こめず	米酢	名詞	
よねくろず	米黒酢	名詞	
こめくろず	米黒酢	名詞	
こうず	香酢	名詞	
こうず	香醋	名詞	
おおむぎす	大麦酢	名詞	
おおむぎず	大麦酢	名詞	
こくもつす	穀物酢	名詞	
かじつす	果実酢	名詞	
りんごす	林檎酢	名詞	
りんごす	りんご酢	名詞	
ぶどうす	葡萄酢	名詞	
ぶどうず	葡萄酢	名詞	
りんごず	林檎酢	名詞	
りんごず	りんご酢	名詞	
ぶどうす	ぶどう酢	名詞	
ぶどうず	ぶどう酢	名詞	
かきす	柿酢	名詞	
かきず	柿酢	名詞	
ひょうさくさん	氷酢酸	名詞	
さくさん	酢酸	名詞	
よしのす	吉野酢	名詞	
よしのず	吉野酢	名詞	
しろず	白酢	名詞	→しらず
しらず	白酢	名詞	
うめす	梅酢	名詞	
うめず	梅酢	名詞	
あかず	赤酢	名詞	→梅酢
あかす	赤酢	名詞	
すみそ	酢味噌	名詞	
きみす	黄身酢	名詞	
