ゔぇーる	VERT	名詞	
ゔぇーる	ヴェール	名詞	
あーるぐれい	EARL GREY	名詞	
あーるぐれい	伯爵茶	名詞	
あいおいばんちゃ	相生番茶	名詞	
あいしん	愛心	名詞	
あいしんたおめい	愛心桃美	名詞	
あいぶん	愛文	名詞	
あいもん	愛文	名詞	
あおいちご	ブルーベリー	名詞	
あおいちご	藍莓	名詞	
あおじそりょくちゃ	青紫蘇緑茶	固有名詞	
あおだ	青沱	名詞	
あおちゃ	青茶	名詞	
あおはね	青羽根	固有名詞	
あおばな	青花	名詞	
あおぷーあーる	生普洱	名詞	
あおぷーあーる	青普洱	名詞	
あおぷーある	生普洱	名詞	
あおぷーある	青普洱	名詞	
あおぷあーる	生普洱	名詞	
あおぷあーる	青普洱	名詞	
あおもち	青餅	名詞	
あおわんだー	奥萬大	名詞	
あおわんだーてぃえぐあんいん	奥萬大鉄観音	名詞	
あかうーろん	紅烏龍	名詞	
あかしめいちゃ	赤石銘茶	名詞	
あかちゃ	紅茶	名詞	
あかちゃんばんちゃ	赤ちゃんばん茶	固有名詞	
あがたのもり	県の杜	固有名詞	
あきちゃ	秋茶	名詞	
あきばんちゃ	秋ばん茶	固有名詞	
あきふゆばんちゃ	秋冬ばん茶	固有名詞	
あきふゆばんちゃ	秋冬番茶	名詞	
あくつい	渥堆	名詞	
あさぎりちゃ	あさぎり茶	名詞	
あさごみどり	朝来みどり	名詞	
あさひえん	朝日園	固有名詞	
あさひなぎょくろ	朝比奈玉露	名詞	
あさみやちゃ	朝宮茶	名詞	
あさむし	浅蒸し	名詞	
あしがらちゃ	足柄茶	名詞	
あしくぼちゃ	足久保茶	名詞	
あしべのしろ	葦辺の白	固有名詞	
あすけかんちゃ	足助寒茶	名詞	
あずみのそばちゃ	安曇野そば茶	固有名詞	
あっさみか	assamica	名詞	
あっさみか	var. assamica	名詞	
あっさみか	アッサミカ	名詞	
あっぷる	蘋果	名詞	
あつたい	渥堆	名詞	
あてちゃ	当て茶	名詞	
あとはっこう	後発酵	名詞	
あながま	窖窯	名詞	
あぷりこっと	杏樹	名詞	
あまあじ	甘味	名詞	
あまちゃづる	甘茶蔓	名詞	
あやたか	綾鷹	固有名詞	
あらちゃ	荒茶	名詞	
あられ	小霰	名詞	
ありさんちゃ	阿里山茶	名詞	
ありざん	阿里山	地名	
あるみぱっく	アルミパック	名詞	
あわばんちゃ	阿波番茶	名詞	
あんかしょうしん	安化松針	名詞	
あんじゅ	アプリコット	名詞	
あんじゅ	杏樹	名詞	
あんにんか	杏仁香	名詞	
あんにんこう	杏仁香	名詞	
あんぶんのしろ	安分の白	固有名詞	
あんぺりある	アンペリアル	名詞	
いーらん	王蘭	名詞	
いーらんしゃん	王蘭香	名詞	
いいなんちゃ	飯南茶	名詞	
いぇらいしゃん	夜来香	名詞	
いぇんふぇん	銀峰	名詞	
いえもん	伊右衛門	固有名詞	
いがちゃ	伊賀茶	名詞	
いしうすびき	石臼挽き	名詞	
いしづちくろちゃ	石鎚黒茶	名詞	
いしづちこくちゃ	石鎚黒茶	名詞	
いずもちゃ	出雲茶	名詞	
いせちゃ	伊勢茶	名詞	
いせのみどり	伊勢の緑	固有名詞	
いたづくり	板作り	名詞	
いちげつ	一穴	名詞	
いちげんしょうじょう	一見鐘情	名詞	
いちご	草莓	名詞	
いちば	一葉	名詞	
いちばちゃ	一葉茶	名詞	
いちばんちゃ	一番茶	名詞	
いちょう	萎凋	名詞	
いっきょうくちゃ	一叶苦茶	名詞	
いっきょうちゃ	一叶茶	名詞	
いっけつ	一穴	名詞	
いっけんしょうじょう	一見鐘情	名詞	
いっしんいちよう	一芯一葉	名詞	
いっしんさんよう	一芯三葉	名詞	
いっしんによう	一芯二葉	名詞	
いなぐち	いなぐち	固有名詞	
いなちゃ	伊那茶	名詞	
いなん	萎軟	名詞	
いはらちゃ	庵原茶	名詞	
いびちゃ	揖斐茶	名詞	
いみ	異味	名詞	
いろかわちゃ	色川茶	名詞	
いわしみず	岩しみず	固有名詞	
いわちゅう	岩鋳	固有名詞	
いんかん	員環	助数詞	
いんごう	銀勾	名詞	
いんさーりえんかー	銀色恋歌	固有名詞	
いんぢぇん	銀針	名詞	
いんで	英徳	名詞	
いんでー	英徳	名詞	
いんどーる	INDOLE	名詞	
いんどーる	インドール	名詞	
いんびちゃ	因尾茶	名詞	
いんんちぇん	銀針	名詞	
うーしゃん	五香	名詞	
うーすー	五色	名詞	
うーとん	鳥棟	名詞	
うーどん	雲頂	名詞	
うぇい	味	名詞	
うぇんしゃんぱおじょん	文山包種	固有名詞	
うぇんしゃんぺい	温馨杯	名詞	
うぇんしゃんぺい	聞香杯	名詞	
うか	雨花	名詞	
うぎゅうそう	烏牛早	名詞	
うご	雨後	名詞	
うごちゃ	雨後茶	名詞	
うじしちめいえん	宇治七名園	固有名詞	
うじちゃ	宇治茶	名詞	
うじばんちゃ	宇治番茶	名詞	
うぜん	雨前	名詞	
うぜんちゃ	雨前茶	名詞	
うみかい	海貝	名詞	
うめがしまちゃ	梅ヶ島茶	名詞	
うめこぶちゃ	梅昆布茶	名詞	
うらぶた	裏蓋	名詞	
うり	匏	名詞	
うりこきん	瓜子金	名詞	
うれしのちゃ	嬉野茶	名詞	
うわちゃ	宇和茶	名詞	
うんか	浮塵子	名詞	
うんごう	雲毫	名詞	
うんしゅう	温州	名詞	
うんしゅうみかん	温州みかん	固有名詞	
うんせい	雲栖	名詞	
うんちょう	雲頂	名詞	
うんなんしちしぺいちゃ	雲南七子餅茶	名詞	
うんなんしょうだちゃ	雲南小沱茶	名詞	
うんふう	温壺	名詞	
うんべい	温杯	名詞	
うんほう	雲峰	名詞	
うんむ	雲霧	名詞	
えいこう	英紅	名詞	
えいしゅんぶっしゅ	永春佛手	名詞	
えいちゃ	えい茶	名詞	
えいとくきんぎ	英徳金萱	名詞	
えいとくきんせん	英徳金萱	名詞	
えいとくこうちゃ	英徳紅茶	名詞	
えつけがま	絵付窯	名詞	
えびすぐさ	恵比須草	名詞	
えぴすてーめーちゃろう	恵比寿亭茗茶楼	固有名詞	
えんくんみ	煙薫味	名詞	
えんしょうしゅ	烟小種	名詞	
えんしょうせい	円炒青	名詞	
えんじゅ	円珠	名詞	
えんじゅけい	円珠形	名詞	
えんちゃ	圓茶	名詞	
おーたむなる	AUTUMNAL	形容詞	
おーたむなる	オータムナル	形容詞	
おうか	櫻花	名詞	
おうかんのん	黄観音	名詞	
おうが	黄芽	名詞	
おうごんけい	黄金桂	名詞	
おうしょう	黄小	名詞	
おうたん	黄旦	名詞	
おうだい	黄大	名詞	
おうちゃ	黄茶	名詞	
おうでい	黄泥	名詞	
おうとう	黄湯	名詞	
おうとう	櫻桃	名詞	
おうまんだい	奥萬大	名詞	
おうまんだいてっかんのん	奥萬大鉄観音	名詞	
おうまんだいてつかんのん	奥萬大鉄観音	名詞	
おうよう	黄葉	名詞	
おおいした	覆下	名詞	
おおうきょう	大烏叶	名詞	
おおうぎょう	大烏叶	名詞	
おおえき	大益	名詞	
おおおきょう	大烏叶	名詞	
おおおぎょう	大烏叶	名詞	
おおだいちゃ	大台茶	名詞	
おおぼりそうまやき	大堀相馬焼	名詞	
おおやく	大益	名詞	
おかのにじ	丘の虹	固有名詞	
おかべちゃ	岡部茶	名詞	
おがさちゃ	小笠茶	名詞	
おくのやま	奥の山	固有名詞	
おくのやまえん	奥の山園	固有名詞	
おちゃえん	御茶園	名詞	
おちゃのきむらえん	お茶の木村園	固有名詞	
おとなしちゃ	音無茶	名詞	
おもがし	主菓子	名詞	
おるづぉ	ORZO	名詞	
おるづぉ	オルヅォ	名詞	
おれんじ	柳橙	名詞	
おれんじぴーる	陳皮	名詞	
おんいん	音韻	名詞	
おんきょうはい	温馨杯	名詞	
おんしぎょくろ	恩施玉露	名詞	
おんしゅう	温州	名詞	
おんはい	温杯	名詞	
おんふう	温壺	名詞	
かいがい	海貝	名詞	
かいがいとじゅ	海貝吐珠	名詞	
かいなんくちょうちゃ	海南苦丁茶	名詞	
かいみ	回味	名詞	
かいりゅう	海龍	名詞	
かえん	花園	名詞	
かえんほう	火焔峰	名詞	
かおりちゃ	香茶	名詞	
かか	果香	名詞	
かか	花果	名詞	
かかい	花開	名詞	
かかけん	花香顕	名詞	
かかちゃ	花果茶	名詞	
かが	香芽	名詞	
かがきんぱくちゃ	加賀金箔茶	固有名詞	
かがちゃ	加賀茶	名詞	
かがぼううめちゃ	加賀棒梅茶	固有名詞	
かがぼうちゃ	加賀棒茶	名詞	
かきさん	花旗蔘	名詞	
かきしん	花旗蔘	名詞	
かきのは	柿の葉	名詞	
かきのはほうじちゃ	柿の葉焙じ茶	固有名詞	
かきは	柿葉	名詞	
かくざんおうが	霍山黄芽	名詞	
かくざんこうが	霍山黄芽	名詞	
かぐら	家蔵	名詞	
かけがわちゃ	掛川茶	名詞	
かこう	果香	名詞	
かこうが	化香蛾	名詞	
かこうがちゃ	化香蛾	名詞	
かこうけん	花香顕	名詞	
かごう	花郷	固有名詞	
かごしまちゃ	鹿児島茶	名詞	
かさっせい	鍋殺青	名詞	
かさん	貨山	名詞	
かさんりゅう	過山龍	名詞	
かざりぶた	飾り蓋	名詞	
かざん	貨山	名詞	
かざんりゅう	過山龍	名詞	
かしきん	瓜子金	名詞	
かしついちょう	加湿萎凋	名詞	
かしゅひ	仮種皮	名詞	
かそうちゃ	花草茶	名詞	
かたちゃ	片茶	名詞	
かたづくり	型作り	名詞	
かだ	花朶	名詞	
かだけい	花朶形	名詞	
かちゃ	夏茶	名詞	
かちゃ	花茶	名詞	
かちょう	柯朝	人名	
かっちゃ	活茶	名詞	
かつかみあわばんちゃ	上勝阿波晩茶	名詞	
かつがいてんちゃすい	掲蓋添茶水	名詞	
かつちゃ	活茶	名詞	
かとう	下投	名詞	
かとうとうほう	下投投法	名詞	
かとうほう	下投法	名詞	
かなさな	金鑽	名詞	
かなやちゃ	金谷茶	名詞	
かひん	香檳	名詞	
かふぇいん	咖啡因	名詞	
かぶきちゃ	歌舞伎茶	名詞	
かぶせしんちゃ	かぶせ新茶	固有名詞	
かぶせちゃ	かぶせ茶	名詞	
かへん	瓜片	名詞	
かまいり	釜炒り	名詞	
かまか	釜香	名詞	
かまこう	釜香	名詞	
かみつれ	カモミール	名詞	
かみつれ	加密列	名詞	
かめい	花茗	名詞	
かめい	香茗	名詞	
かめやまちゃ	亀山茶	名詞	
かもみーる	加密列	名詞	
かもみーる	甘菊	名詞	
から	過羅	名詞	
からちゃ	カラ茶	名詞	
かりがねちゃ	かりがね茶	名詞	
かりそん	カリソン	固有名詞	
かりゅうけい	顆粒形	名詞	
かる	瓜芦	名詞	
かろ	瓜芦	名詞	
かろ	瓜盧	名詞	
かろてのいど	カロテノイド	名詞	
かわごえちゃ	川越茶	名詞	
かわしもえん	川下園	固有名詞	
かわぞえちゃ	川添茶	名詞	
かわねちゃ	川根茶	名詞	
かわらか	清爽	固有名詞	
かんか	観花	名詞	
かんかちゃ	観花茶	名詞	
かんしょう	漢鐘	名詞	
かんじゅくまんごーうーろん	完熟マンゴー烏龍	固有名詞	
かんぞう	甘草	名詞	
かんちゃか	干草香	名詞	
かんちゃく	揀剔	名詞	
かんちゃこう	干草香	名詞	
かんていぐみ	鑑定組	名詞	
かんていそ	鑑定組	名詞	
かんてき	揀剔	名詞	
かんとんうーろん	広東烏龍	名詞	
かんにゅう	貫入	名詞	
かんにゅうふん	貫入粉	名詞	
かんのんおう	観音王	名詞	
かんみ	甜味	名詞	
かんよう	還陽	名詞	
がいきどう	外鬼洞	名詞	
がいつぇん	蓋枕	名詞	
がいぺい	蓋杯	名詞	
がいわん	蓋椀	名詞	
がおきゃお	高橋	名詞	
がくせい	岳西	名詞	
がび	峨眉	名詞	
がびちくようせい	峨眉竹葉青	名詞	
がらす	玻璃	名詞	
がんいん	岩韻	名詞	
がんおーん	ガンオーン	名詞	
がんおーん	軟枝	名詞	
がんこつ	岩骨	名詞	
がんちゃ	巌茶	名詞	
がんちゃ	岩茶	名詞	
がんちゅうらん	岩中蘭	名詞	
がんほう	元宝	名詞	
がんるー	甘露	名詞	
きーほん	祁紅	名詞	
きーめん	祁門	名詞	
きあんりあんちゃ	千両茶	名詞	
きいのむかし	紀伊の昔	固有名詞	
きうい	奇異果	名詞	
きえか	黄枝香	名詞	
きえこう	黄枝香	名詞	
きかんのん	黄観音	名詞	
ききちゃ	聞き茶	名詞	
ききょく	器局	名詞	
きくか	菊花	名詞	
きくかちゃ	菊花茶	名詞	
きくがわちゃ	菊川茶	名詞	
きこどう	奇古堂	固有名詞	
きし	黄枝	名詞	
きしか	黄枝香	名詞	
きしこう	黄枝香	名詞	
きしゅ	奇種	名詞	
きしゅうくちょうちゃ	貴州苦丁茶	名詞	
きたん	奇丹	名詞	
きちゃ	黄茶	名詞	
きちゃ	生茶	名詞	
きっさようじょうき	喫茶養生記	固有名詞	
きっぷーちゃ	菊普茶	名詞	
きっぷうちゃ	菊普茶	名詞	
きてい	貴定	名詞	
きでい	黄泥	名詞	
きのつかさ	紀之司	固有名詞	
きのむかし	紀之昔	固有名詞	
きば	黄葉	名詞	
きひちゃ	貴妃茶	名詞	
きほう	奇芳	名詞	
きほくちゃ	鬼北茶	名詞	
きむらえん	木村園	固有名詞	
きゅうきょく	九曲	名詞	
きゅうきょくこうばい	九曲紅梅	固有名詞	
きゅうこう	鳩口	名詞	
きゅうじゅんめいちゃ	久順銘茶	固有名詞	
きゅうとう	九桃	名詞	
きゅうりゅうくつ	九竜窟	名詞	
きゆ	黄湯	名詞	
きょうき	喬木	名詞	
きょうせい	烘青	名詞	
きょうばんちゃ	京番茶	名詞	
きょうぼく	喬木	名詞	
きょうもく	喬木	名詞	
きょくめい	曲茗	名詞	
きらん	奇蘭	名詞	
きんあつ	緊圧	名詞	
きんおう	緊壓	名詞	
きんおうちゃ	緊壓茶	名詞	
きんかん	巾函	名詞	
きんかんのん	金観音	名詞	
きんぎ	金萱	名詞	
きんぎょく	錦玉	名詞	
きんけい	金鶏	名詞	
きんけん	金萱	名詞	
きんげんぽう	金元宝	名詞	
きんこう	巾盒	名詞	
きんこちょう	金胡蝶	名詞	
きんころ	金葫芦	名詞	
きんごう	金毫	名詞	
きんさじ	金鎖匙	名詞	
きんさぢ	金鎖匙	名詞	
きんさぢぃ	金鎖匙	名詞	
きんさん	金鑽	名詞	
きんしゅう	金繍	名詞	
きんしょう	巾床	名詞	
きんしょう	巾承	名詞	
きんしょう	金奨	名詞	
きんしん	金針	名詞	
きんしんちゃせん	金針茶磚	名詞	
きんじょう	錦上	名詞	
きんじょうてんか	錦上添花	名詞	
きんせん	金萱	名詞	
きんせんとう	金仙桃	名詞	
きんだるま	金達摩	名詞	
きんちゃ	緊茶	名詞	
きんとう	巾筒	名詞	
きんぱくちゃ	金箔茶	名詞	
きんぶつ	金佛	名詞	
きんへん	金片	名詞	
きんへんたんそう	金片単叢	名詞	
きんぺん	金片	名詞	
きんぺんたんそう	金片単叢	名詞	
きんほう	金蓬	名詞	
きんほうおう	金鳳凰	名詞	
きんほうがんほう	金蓬元宝	名詞	
きんほうちょうよう	金鳳朝陽	名詞	
きんりゅうじょう	金柳条	名詞	
ぎこう	宜紅	名詞	
ぎこう	祁紅	名詞	
ぎゅうにゅう	牛奶	名詞	
ぎょうぼく	喬木	名詞	
ぎょうもく	喬木	名詞	
ぎょくらんか	玉蘭香	名詞	
ぎょくらんこう	玉蘭香	名詞	
ぎょくりんえん	玉林園	固有名詞	
ぎょくれん	玉蓮	名詞	
ぎょせい	魚腥	名詞	
ぎょせいそう	魚腥草	名詞	
ぎょっこしゅん	玉壺春	名詞	
ぎんこう	銀猴	名詞	
ぎんこう	銀鉤	名詞	
ぎんごう	銀毫	名詞	
ぎんしゅんび	銀駿眉	名詞	
ぎんしん	銀針	名詞	
ぎんねむくがに	ぎんねむ黄金	固有名詞	
くいふぁ	桂花	名詞	
くいふぁー	桂花	名詞	
くかい	玖瑰	名詞	
くかいじゅ	玖瑰珠	名詞	
くかいじゅちゃ	玖瑰珠茶	名詞	
くきちゃ	茎茶	名詞	
くこ	枸杞	名詞	
くさいちご	草莓	名詞	
くちょう	苦丁	名詞	
くちょうじゅ	苦丁樹	名詞	
くちょうちゃ	苦丁茶	名詞	
くちん	苦丁	名詞	
くちんちゃ	苦丁茶	名詞	
くまざさ	隈笹	名詞	
くまちゃ	久万茶	名詞	
くまもとちゃ	くまもと茶	名詞	
くりーむだうん	クリームダウン	名詞	
くりゅうくつ	九竜窟	名詞	
くろーなる	クローナル	名詞	
くろだ	黒沱	名詞	
くろぷーあーる	黒普洱	名詞	
くろぷーあーる	熟普洱	名詞	
くろぷーある	黒普洱	名詞	
くろぷーある	熟茶	名詞	
くろぷあーる	黒普洱	名詞	
くろぷあーる	熟普洱	名詞	
くろみつきなこ	黒蜜きなこ	固有名詞	
くわちゃ	桑茶	名詞	
ぐーらお	古労	名詞	
ぐーらおちゃ	古労茶	名詞	
ぐいふぇいちゃ	貴妃茶	名詞	
ぐうく	茹苦	名詞	
ぐうくちゃ	茹苦茶	名詞	
ぐおしゃん	果香	名詞	
ぐき	貢熙	名詞	
ぐりちゃ	ぐり茶	名詞	
ぐれーぷふるーつ	葡萄柚	名詞	
ぐんたいか	群体香	名詞	
ぐんたいこう	群体香	名詞	
けいいん	桂圓	名詞	
けいか	桂花	名詞	
けいかか	桂花香	名詞	
けいかこう	桂花香	名詞	
けいさんかめい	径山香茗	固有名詞	
けいさんこうめい	径山香茗	固有名詞	
けいざんかめい	径山香茗	固有名詞	
けいざんこうめい	径山香茗	固有名詞	
けいたいすいとう	携帯水筒	名詞	
けいてい	敬亭	名詞	
けいはっこう	軽発酵	名詞	
けいめい	恵明	名詞	
けいよう	佳葉	名詞	
けしきん	瓜子金	名詞	
けせんせいちゃ	気仙清茶	固有名詞	
けせんちゃ	気仙茶	名詞	
けせんちゃものがたり	気仙茶ものがたり	固有名詞	
けちゃ	毛茶	名詞	
けつめいし	決明子	名詞	
ける	瓜芦	名詞	
けろ	瓜芦	名詞	
けろ	瓜盧	名詞	
けんきせい	嫌気性	名詞	
けんきょく	巻曲	名詞	
けんきょくけい	巻曲形	名詞	
けんこうし	懸鈎子	名詞	
けんちゃく	揀剔	名詞	
けんてき	揀剔	名詞	
げいしゅんりゅう	迎春柳	名詞	
げいちゃ	迎茶	固有名詞	
げかん	下関	名詞	
げざん	外山	名詞	
げざんしょうしゅ	外山小種	名詞	
げんぴ	減肥	名詞	
げんへん	原片	名詞	
げんぺん	原片	名詞	
げんぽう	元宝	名詞	
げんまいちゃ	玄米茶	名詞	
こいあじ	濃味	名詞	
こいうた	恋歌	名詞	
こううーろん	紅烏龍	名詞	
こうえ	黄枝	名詞	
こうえこう	黄枝香	名詞	
こうか	高火	名詞	
こうか	高香	名詞	
こうかい	猴魁	名詞	
こうかいばつ	高海抜	名詞	
こうかく	黄鶴	名詞	
こうかくてんしゅ	黄鶴展趣	名詞	
こうから	紅香螺	名詞	
こうかんのん	黄観音	名詞	
こうが	黄芽	名詞	
こうが	香芽	名詞	
こうき	貢熙	名詞	
こうきせい	好気性	名詞	
こうきせいぶん	香気成分	名詞	
こうきゅう	甲級	名詞	
こうきょうぎんほう	高橋銀峰	名詞	
こうきょく	香曲	名詞	
こうぎく	黄菊	名詞	
こうぎく	貢菊	名詞	
こうぎくせんとう	黄菊仙桃	名詞	
こうぎょく	紅玉	名詞	
こうげいちゃ	工芸茶	名詞	
こうげいちゃ	工藝茶	名詞	
こうこう	高香	名詞	
こうこうら	紅香螺	名詞	
こうごう	香合	名詞	
こうさん	江山	名詞	
こうざん	江山	名詞	
こうざんぎんこう	黄山銀鉤	固有名詞	
こうざんちゃ	高山茶	名詞	
こうざんもうほう	黄山毛峰	固有名詞	
こうし	黄枝	名詞	
こうし	公司	名詞	
こうしこう	黄枝香	名詞	
こうしゅうきゅう	紅繍球	名詞	
こうしゅん	香駿	固有名詞	
こうしょう	黄小	名詞	
こうしろぎく	貢白菊	固有名詞	
こうしん	紅心	名詞	
こうすい	紅水	名詞	
こうせい	烘青	名詞	
こうせっちゃ	紅雪茶	名詞	
こうせつちゃ	紅雪茶	名詞	
こうせん	高鮮	名詞	
こうせんとう	紅仙桃	名詞	
こうそうじきゅう	高爽持久	名詞	
こうそくはい	高足杯	名詞	
こうたん	黄旦	名詞	
こうだい	黄大	名詞	
こうだい	高台	名詞	
こうちくとうちゃ	香竹筒茶	名詞	
こうちゃ	貢茶	名詞	
こうちゃかん	紅茶館	名詞	
こうちゃとう	紅茶党	名詞	
こうちゃのじょうおう	紅茶の女王	名詞	
こうてん	高甜	名詞	
こうとう	黄湯	名詞	
こうどう	香道	名詞	
こうはい	口杯	名詞	
こうばい	烘焙	名詞	
こうひん	香檳	名詞	
こうびれい	紅美麗	名詞	
こうふーしき	功夫式	名詞	
こうへん	香片	名詞	
こうぼく	紅木	名詞	
こうみ	香味	名詞	
こうめい	香茗	名詞	
こうよう	黄葉	名詞	
こうようとくそく	黄葉特早	名詞	
こうら	紅螺	名詞	
こうりょく	杭緑	名詞	
こうる	紅螺	名詞	
こうれい	高冷	名詞	
こうれいちゃ	高冷茶	名詞	
こうろ	香露	名詞	
こうろ	皐蘆	名詞	
こくさいめいちゃ	国際名茶	名詞	
こくせん	谷尖	名詞	
こくだ	黒沱	名詞	
こくちゃ	黒茶	名詞	
こくはいしょく	黒灰色	名詞	
こくりょくでい	黒緑泥	名詞	
こけちゃ	苔茶	名詞	
こしょ	顧渚	名詞	
こしょししゅん	顧渚紫笋	名詞	
こじー	コジー	名詞	
こちゃしゅう	古茶臭	名詞	
こちゃじゅ	古茶樹	名詞	
こつじ	ボーンチャイナ	名詞	
こつじ	骨瓷	名詞	
ことしこそ	今年こそ	固有名詞	
こなちゃ	粉茶	名詞	
このは	木葉	名詞	
このめえん	茶乃芽園	固有名詞	
こぶくさ	古袱紗	名詞	
こほくらんけいせっかすい	湖北蘭渓石下水	名詞	
こもれび	木漏れ陽	固有名詞	
こゅぃ	濃ゅぃ	名詞	
こゆい	濃ゆい	名詞	
ころ	葫芦	名詞	
ころう	古労	名詞	
ころうちゃ	古労茶	名詞	
こんふー	工夫	名詞	
こんふーちゃき	工夫茶器	名詞	
こんへらん	金辺蘭	名詞	
こんめい	昆明	名詞	
ごーや	ゴーヤ	名詞	
ごーや	苦瓜	名詞	
ごいしちゃ	碁石茶	固有名詞	
ごう	盒	名詞	
ごうか	毫香	名詞	
ごうかんさん	合歓山	名詞	
ごうかんざん	合歓山	名詞	
ごうこう	毫香	名詞	
ごかせちゃ	五ヶ瀬茶	名詞	
ごくう	悟空	固有名詞	
ごくひん	極品	名詞	
ごくらくちゃえん	極楽茶園	固有名詞	
ごし	午子	名詞	
ごしき	五色	名詞	
ごだきんか	五朶金花	名詞	
ごふくじゅ	伍福寿	固有名詞	
ごふくじゅ	伍福壽	固有名詞	
ごんふー	功夫	名詞	
さいかこうちゃ	再加工茶	名詞	
さいかちょう	彩花鳥	名詞	
さいころんじん	西湖龍井	名詞	
さいさん	賽山	名詞	
さいざん	賽山	名詞	
さいせい	晒青	名詞	
さいせいりょくちゃ	晒青緑茶	名詞	
さいちゃ	彩茶	固有名詞	
さいちん	晒青	名詞	
さいてき	採摘	名詞	
さいどん	細嫩	名詞	
さいのん	細嫩	名詞	
さいよう	ブロークン	名詞	
さいよう	碎葉	名詞	
さいようがた	碎葉型	名詞	
さいようけい	碎葉型	名詞	
さいれん	彩蓮	名詞	
さか	茶菓	名詞	
さがらみどり	相良みどり	名詞	
さくしゅうばんちゃ	作州番茶	名詞	
さくせい	做青	名詞	
さくらちゃ	佐倉茶	名詞	
さくらんぼ	櫻桃	名詞	
さしまちゃ	猿島茶	名詞	
さっせい	殺青	名詞	
さつまちゃ	薩摩茶	名詞	
さび	茶炙	名詞	
さふるーる	茶花花茶	固有名詞	
さぼう	茶坊	名詞	
さや	匣鉢	名詞	
さんいん	山韻	名詞	
さんかくぱっく	三角パック	名詞	
さんかはっこう	酸化発酵	名詞	
さんこうしちりょく	三紅七緑	名詞	
さんざし	山査子	名詞	
さんざしぼう	山査子棒	名詞	
さんすいちゃ	三水茶	名詞	
さんちゃ	山茶	名詞	
さんちゃ	散茶	名詞	
さんちゃ	酸茶	名詞	
さんどうちゃ	三道茶	名詞	
さんどぐらすてぃー	SAND GLASS TEA	固有名詞	
さんどぐらすてぃー	サンドグラスティー	固有名詞	
さんばいこう	三杯香	固有名詞	
さんばんちゃ	三番茶	名詞	
さんぴんちゃ	さんぴん茶	名詞	
さんふねん	三不粘	名詞	
さんぷくちゃ	三福茶	固有名詞	
さんぷちゃん	三不粘	名詞	
さんほうだい	三泡台	名詞	
さんほうちゃ	三邦茶	名詞	
さんぽうちゃ	三邦茶	名詞	
さんようちゅうちゃ	三葉虫茶	名詞	
さんろくちゃ	山麓茶	名詞	
さんわん	三湾	名詞	
ざんか	残香	名詞	
ざんこう	残香	名詞	
しーくゎーさー	シークヮーサー	名詞	
しーくゎーさー	平実檸檬	名詞	
しーくわさー	シークワサー	名詞	
しーちんるー	石亭緑	名詞	
しーふー	西湖	名詞	
しぇんたお	仙桃	名詞	
しぇんにー	仙女	名詞	
しぇんにーしぇんたお	仙女仙桃	名詞	
しきさいへんさ	色彩偏差	名詞	
しきしゅん	四季春	名詞	
しきはる	四季春	名詞	
しきん	紫金	名詞	
しきんしょく	紫金色	名詞	
しさ	紫砂	名詞	
ししほう	獅子峰	名詞	
ししゅん	紫笋	名詞	
ししゅんちゃ	紫笋茶	名詞	
しじん	四神	名詞	
しずおかちゃ	静岡茶	名詞	
しぜんいちょう	自然萎凋	名詞	
しぜんちゃ	自然茶	名詞	
しちせんにょ	七仙女	名詞	
しちゃ	紫茶	名詞	
しっすい	失水	名詞	
しでい	紫泥	名詞	
しなもん	肉桂	名詞	
しぶかわちゃ	渋川茶	名詞	
しほうみんぜん	獅峰明前	名詞	
しほうめんぜん	獅峰明前	名詞	
しまばらちゃ	島原茶	名詞	
しゃお	小	形容詞	
しゃおしゃんばいちゃこうぼう	しゃおしゃん焙茶工房	固有名詞	
しゃおじぇ	小姐	名詞	
しゃおじょん	小種	名詞	
しゃおちえ	小姐	名詞	
しゃおちん	小青	名詞	
しゃおばい	小白	名詞	
しゃおぱい	小白	名詞	
しゃくぜつ	雀舌	名詞	
しゃすいき	煮水器	名詞	
しゃせんしょういひん	煮泉小品	名詞	
しゃん	香	名詞	
しゃんしゃん	香香	名詞	
しゃんしゅ	シャン種	名詞	
しゃんじゅーとんちゃ	香竹筒茶	名詞	
しゃんじゅうとんちゃ	香竹筒茶	名詞	
しゃんぴん	香檳	名詞	
しゅーふー	舒服	名詞	
しゅいしぇん	水仙	名詞	
しゅういん	秋韻	名詞	
しゅうきゅう	繍球	名詞	
しゅうちゃ	州茶	名詞	
しゅうちゃ	秋茶	名詞	
しゅうとうばんちゃ	秋冬番茶	名詞	
しゅうび	秀眉	名詞	
しゅうびちゃ	秀美茶	名詞	
しゅうれんみ	収斂味	名詞	
しゅくせん	祝仙	名詞	
しゅでい	朱泥	名詞	
しゅほう	珠宝	名詞	
しゅほう	珠峰	名詞	
しゅんう	春雨	名詞	
しゅんごう	春毫	名詞	
しゅんじんくい	水金亀	名詞	
しゅんぜん	春前	名詞	
しゅんぜんちゃ	春前茶	名詞	
しゅんちゃ	春茶	名詞	
しゅんめい	しゅんめい	固有名詞	
しょううんのしろ	松雲の白	固有名詞	
しょうえん	松烟	名詞	
しょうおういん	小黄印	名詞	
しょうか	宵花	名詞	
しょうか	小花	名詞	
しょうかくとう	小核桃	名詞	
しょうが	生薑	名詞	
しょうがなこうちゃ	生姜な紅茶	固有名詞	
しょうきろっぽう	小貴六方	名詞	
しょうこう	紹興	名詞	
しょうこういん	小黄印	名詞	
しょうこうほう	小紅袍	名詞	
しょうさいせい	小西施	名詞	
しょうしん	松針	名詞	
しょうじゅ	松寿	固有名詞	
しょうじゅこ	樟樹湖	名詞	
しょうじゅこう	樟樹湖	名詞	
しょうせい	小青	名詞	
しょうせい	炒青	名詞	
しょうせいほう	炒青法	名詞	
しょうせいりょくちゃ	炒青緑茶	名詞	
しょうたい	昌泰	名詞	
しょうだ	小沱	名詞	
しょうちゃがも	樟茶鴨	名詞	
しょうとう	小沱	名詞	
しょうとうか	焦糖香	名詞	
しょうとうこう	焦糖香	名詞	
しょうとうちゃ	小沱茶	名詞	
しょうはく	小白	名詞	
しょうはく	松柏	名詞	
しょうばくか	炒麦香	名詞	
しょうばくこう	炒麦香	名詞	
しょうびゃく	松柏	名詞	
しょうめい	寿眉	名詞	
しょうようしゅ	小葉種	名詞	
しょうらしょうせい	松羅炒青	名詞	
しょうらん	井欄	名詞	
しょうらんか	小蘭花	名詞	
しょうらんふう	井欄壷	名詞	
しょばい	初焙	名詞	
しょふく	舒服	名詞	
しょぶく	舒服	名詞	
しよう	柿葉	名詞	
しよう	紫陽	名詞	
しらおれ	白折	名詞	
しらかわちゃ	白川茶	名詞	
しろちゃ	白茶	名詞	
しろぼたん	白牡丹	名詞	
しろりゅうじゅ	白龍珠	名詞	
しろろんじん	白龍井	名詞	
しんおう	針王	名詞	
しんか	真香	名詞	
しんぐうちゃ	新宮茶	名詞	
しんこう	真香	名詞	
しんしん	心心	名詞	
しんしんしゃんいん	心心相印	名詞	
しんじょうちゃ	新城茶	名詞	
しんそうめいちゃ	新創名茶	名詞	
しんたん	震旦	名詞	
しんちゅうおう	新中横	名詞	
しんてん	新店	名詞	
しんのう	神農	名詞	
しんぱい	真杯	名詞	
しんやんまおじぇん	信陽毛尖	名詞	
しんようもうせん	信陽毛尖	名詞	
しんら	針螺	名詞	
しんりゅー	滇緑	名詞	
じーぱい	姫牌	名詞	
じーぱいぷーあーるちゃ	姫牌プーアール茶	固有名詞	
じぇんべい	真杯	名詞	
じき	瓷器	名詞	
じくかか	柚花香	名詞	
じくかこう	柚花香	名詞	
じごくそば	地獄蕎麦	名詞	
じっか	熟香	名詞	
じっかか	柚花香	名詞	
じっかこう	柚花香	名詞	
じっこう	熟香	名詞	
じみ	滋味	名詞	
じゃくぜつ	雀舌	形容詞	
じゃくぜつ	雀舌	名詞	
じゃくはっこう	弱発酵	名詞	
じゃすみん	茉莉花	名詞	
じゃすみんしゅんごう	茉莉春毫	固有名詞	
じゃすみんちゃ	茉莉花茶	名詞	
じゃんちゃ	磚茶	名詞	
じゅーけーちゃ	竹殻茶	名詞	
じゅーとんちゃ	竹筒茶	名詞	
じゅうけいちゃ	竹殻茶	名詞	
じゅうせつ	揉切	名詞	
じゅうだいめいちゃ	十大名茶	名詞	
じゅうとんちゃ	竹筒茶	名詞	
じゅうねん	揉捻	名詞	
じゅうはっこう	重発酵	名詞	
じゅうりせんけい	十里潜溪	名詞	
じゅくか	熟香	名詞	
じゅくこう	熟香	名詞	
じゅくだ	熟沱	名詞	
じゅくちゃ	熟茶	名詞	
じゅくちゃせん	熟茶磚	名詞	
じゅくへい	熟餅	名詞	
じゅっか	熟香	名詞	
じゅっこう	熟香	名詞	
じゅつしゃちゃしょうひん	述煮茶小品	名詞	
じゅばいせつれん	珠梅雪蓮	名詞	
じゅび	寿眉	名詞	
じゅほう	珠宝	名詞	
じゅろうえん	寿老園	固有名詞	
じゅんみ	醇味	名詞	
じょあん	如庵	名詞	
じょうきさっせい	蒸气殺青	名詞	
じょうきしゅ	上奇種	名詞	
じょうけい	条形	名詞	
じょうけいちゃ	条形茶	名詞	
じょうじょう	柔情	名詞	
じょうじょう	嫋嫋	形容詞	
じょうじょうせんすい	柔情仙水	名詞	
じょうせい	蒸青	名詞	
じょうせいほう	蒸青法	名詞	
じょうせいりょくちゃ	蒸青緑茶	名詞	
じょうはい	條杯	名詞	
じょじかん	女児環	名詞	
じょふく	舒服	名詞	
じょぶく	舒服	名詞	
じょんしゃん	正山	名詞	
じょんしゃんしゃおじょん	正山小種	名詞	
じよう	柿葉	名詞	
じんしゃん	径山	名詞	
じんしゃんちゃ	径山茶	名詞	
じんしゅあ	金萱	名詞	
じんしゅえん	金萱	名詞	
じんつぁい	精彩	名詞	
すーじーちゅん	四季春	名詞	
すーじょん	色種	名詞	
すーちょん	小種	名詞	
すーふー	舒服	名詞	
すーほんちーるー	三紅七緑	名詞	
すいう	水孟	名詞	
すいえんがん	慧苑岩	名詞	
すいきひ	酔貴妃	名詞	
すいきんき	水金亀	固有名詞	
すいぎょく	翠玉	名詞	
すいげんちゃ	水源茶	名詞	
すいごう	翠毫	名詞	
すいざわちゃ	水沢茶	名詞	
すいしつかんてい	水質鑑定	名詞	
すいせん	祝仙	名詞	
すいせんはく	水仙白	名詞	
すいせんばく	水仙白	名詞	
すいせんぱく	水仙白	名詞	
すいちく	翠竹	名詞	
すいちゃ	吸い茶	名詞	
すいちゅう	水注	名詞	
すいひ	水篩	名詞	
すいひん	水品	名詞	
すいほう	翠峰	名詞	
すいぼん	水盆	名詞	
すいらん	翠蘭	名詞	
すうきどう	数奇道	名詞	
すえちゃ	末茶	名詞	
すしやのこなちゃ	寿司屋の粉茶	固有名詞	
すしんらん	素心蘭	名詞	
すずかちゃ	鈴鹿茶	名詞	
すてんれすかん	ステンレス缶	名詞	
すとろべりー	草莓	名詞	
すみめ	墨芽	名詞	
ずいそうかい	瑞草魁	名詞	
せいか	清香	名詞	
せいか	青花	名詞	
せいがん	正岩	名詞	
せいがんすいせん	正岩水仙	名詞	
せいがんちゃ	正岩茶	名詞	
せいき	青気	名詞	
せいこう	清香	名詞	
せいこう	清高	名詞	
せいころんじん	西湖龍井	名詞	
せいさい	精彩	名詞	
せいさん	西山	名詞	
せいざん	西山	名詞	
せいざんしょうしゅ	正山小種	名詞	
せいしん	青心	名詞	
せいじ	青瓷	名詞	
せいすいさりょう	清水茶寮	固有名詞	
せいせん	青磚	名詞	
せいそう	正叢	名詞	
せいだ	青沱	名詞	
せいちゃ	清茶	名詞	
せいちゃ	青茶	名詞	
せいどん	細嫩	名詞	
せいのん	細嫩	名詞	
せいはくじ	青白磁	名詞	
せいべい	青餅	名詞	
せいらんのほまれ	青藍の誉れ	固有名詞	
せいりゅう	清瀧	名詞	
せいりゅういっせん	清流一煎	固有名詞	
せいろう	青楼	名詞	
せいろんこうちゃほんぽ	錫蘭紅茶本舗	固有名詞	
せいわ	政和	名詞	
せきかく	石角	名詞	
せきしゅん	石笋	名詞	
せきしゅんさん	石笋山	名詞	
せきしゅんざん	石笋山	名詞	
せきじゅん	石笋	名詞	
せきじゅんさん	石笋山	名詞	
せきじゅんざん	石笋山	名詞	
せきじょう	石上	名詞	
せきていりょく	石亭緑	名詞	
せきにゅうか	石乳香	名詞	
せきにゅうこう	石乳香	名詞	
せきひょう	石瓢	名詞	
せちばるちゃ	世知原茶	名詞	
せっかく	石角	名詞	
せっちゃ	雪茶	名詞	
せっぺん	雪片	名詞	
せっぺんとう	雪片頭	名詞	
せつが	雪芽	名詞	
せつちゃ	雪茶	名詞	
せつり	雪梨	名詞	
せつりゅう	雪龍	名詞	
せつりょく	雪緑	名詞	
せらちゃ	世羅茶	名詞	
せん	煎	助数詞	
せん	磚	名詞	
せんぐう	仙寓	名詞	
せんこう	川紅	名詞	
せんごう	仙毫	名詞	
せんしゅつ	煎出	名詞	
せんすい	仙水	名詞	
せんたい	川太	名詞	
せんちゃ	洗茶	名詞	
せんちゃ	磚茶	名詞	
せんちゃすいき	煎茶水記	名詞	
せんちゃどう	煎茶道	名詞	
せんとう	仙桃	名詞	
せんどん	鮮嫩	名詞	
せんにちこう	千日香	名詞	
せんにちこうげんぽう	千日紅元宝	名詞	
せんにちこうしゅうきゅう	千日紅繍球	名詞	
せんにちこうそうせい	千日紅双星	名詞	
せんにょ	仙女	名詞	
せんにょけんか	仙女献花	名詞	
せんにんしょうちゃ	仙人掌茶	名詞	
せんねんこじゅ	千年古樹	名詞	
せんねんこちゃ	千年古茶	名詞	
せんのん	鮮嫩	名詞	
せんばい	仙媒	名詞	
せんぷ	泉譜	名詞	
せんりこう	千里香	固有名詞	
せんりょうちゃ	千両茶	名詞	
ぜんはっこう	全発酵	名詞	
ぜんよう	フルリーフ	名詞	
ぜんよう	全葉	名詞	
ぜんようがた	全葉型	名詞	
ぜんようけい	全葉型	名詞	
そういりょく	双井緑	名詞	
そういん	相印	名詞	
そうきせい	桑寄生	名詞	
そうきせいこうそうたんちゃ	桑寄生紅棗蛋茶	名詞	
そうきせいちゃ	桑寄生茶	名詞	
そうごろくほうちゃ	蒼梧六堡茶	名詞	
そうごろくほちゃ	蒼梧六堡茶	名詞	
そうごろっぽうちゃ	蒼梧六堡茶	名詞	
そうしゅ	宋種	名詞	
そうしゅんちゃ	早春茶	名詞	
そうじんぼく	草人木	固有名詞	
そうすい	走水	名詞	
そうせい	炒青	名詞	
そうせいほう	炒青法	名詞	
そうせいりょくちゃ	炒青緑茶	名詞	
そうばい	草莓	名詞	
そうまやき	相馬焼	名詞	
そうめい	寿眉	名詞	
そくばふー	側把壺	名詞	
そしんらん	素心蘭	名詞	
そてい	粗低	名詞	
そどう	素銅	名詞	
そどうしょく	素銅色	名詞	
そのぎちゃ	彼杵茶	名詞	
そば	蕎麥	名詞	
そばちゃ	蕎麦茶	名詞	
そばのみりょくちゃ	蕎麦の実緑茶	固有名詞	
そんやん	松烟	名詞	
たいえき	大益	名詞	
たいせい	退青	名詞	
たいせきはっこう	堆積発酵	名詞	
たいひ	玳皮	名詞	
たいぴん	太平	名詞	
たいへいこうかい	太平猴魁	固有名詞	
たいほう	大方	名詞	
たいやく	大益	名詞	
たいらおすいりゅー	太姥翠緑	名詞	
たいりくあおちゃ	大陸青茶	名詞	
たいりくせいちゃ	大陸青茶	名詞	
たいろうすいりょく	太姥翠緑	名詞	
たいわんうーろん	台湾烏龍	名詞	
たいわんちゃ	台湾茶	名詞	
たかせちゃ	高瀬茶	名詞	
たからべちゃ	たからべ茶	名詞	
たけうらかん	竹里館	固有名詞	
たけがらちゃ	竹殻茶	名詞	
たけちゃばん	竹茶盤	名詞	
たけづつちゃ	竹筒茶	名詞	
たけばん	竹盤	名詞	
たけまちゃ	岳間茶	名詞	
たたきづくり	叩き作り	名詞	
たたみつき	畳付	名詞	
たはくちゃ	太白茶	名詞	
たばがた	束形	名詞	
たまのお	玉の緒	固有名詞	
たまぶち	玉縁	名詞	
たまりょくちゃ	玉緑茶	固有名詞	
たらよう	多羅葉	名詞	
たりえんしす	TALIENSIS	名詞	
たりえんしす	タリエンシス	名詞	
たわらいちゃ	度会茶	名詞	
たんぐい	丹桂	名詞	
たんぐいぴぁおしゃん	丹桂飄香	名詞	
たんけい	丹桂	名詞	
たんけいひょうか	丹桂瓢香	名詞	
たんこうたんみ	淡香	名詞	
たんそう	単叢	名詞	
たんそう	単欉	名詞	
たんそう	單叢	名詞	
たんそう	單欉	名詞	
たんちゃ	磚茶	名詞	
たんばい	炭焙	名詞	
たんばちゃ	丹波茶	名詞	
たんほう	攤放	名詞	
たんみ	淡味	名詞	
たんりょう	攤涼	名詞	
だー	大	形容詞	
だーじぇ	大姐	名詞	
だーじりん	大吉嶺	名詞	
だーちえ	大姐	名詞	
だーどぅーべい	大肚杯	名詞	
だーばい	大白	名詞	
だーぱい	大白	名詞	
だーほんぱお	大紅枹	名詞	
だいうきょう	大烏叶	名詞	
だいうぎょう	大烏叶	名詞	
だいえき	大益	名詞	
だいおきょう	大烏叶	名詞	
だいおぎょう	大烏叶	名詞	
だいこうほう	大紅袍	名詞	
だいとうばんちゃ	大東番茶	名詞	
だいとはい	大肚杯	名詞	
だいはく	大白	名詞	
だいぶつろんじん	大佛龍井	名詞	
だいめいすいき	大明水記	名詞	
だいやく	大益	名詞	
だいようしゅ	大葉種	名詞	
だちゃ	沱茶	名詞	
だんかいけい	団塊形	名詞	
だんでい	段泥	名詞	
ちーず	七子	名詞	
ちーもん	祁門	名詞	
ちーらん	奇蘭	名詞	
ちぇんしゃんしゃおちょん	正山小種	固有名詞	
ちぇんりーしゃん	千里香	名詞	
ちくとうさんちゃ	竹筒酸茶	名詞	
ちくとうちゃ	竹筒茶	名詞	
ちくようせい	竹葉青	名詞	
ちちゃ	地茶	名詞	
ちとせぼん	千歳盆	名詞	
ちゃーいぇん	チャーイェン	名詞	
ちゃーじーたん	茶鶏蛋	名詞	
ちゃいれ	茶入	名詞	
ちゃおう	茶王	名詞	
ちゃおちん	炒青	名詞	
ちゃおちんほう	炒青法	名詞	
ちゃおちんりょくちゃ	炒青緑茶	名詞	
ちゃか	茶花	名詞	
ちゃか	茶荷	名詞	
ちゃかい	茶海	名詞	
ちゃかかちゃ	茶花花茶	固有名詞	
ちゃかしょ	茶科所	名詞	
ちゃかじょ	茶科所	名詞	
ちゃかん	茶乾	名詞	
ちゃかん	茶缶	名詞	
ちゃかん	茶館	名詞	
ちゃがいちゃ	茶外茶	名詞	
ちゃきょう	茶経	固有名詞	
ちゃきんづつ	茶巾筒	名詞	
ちゃぎょう	茶業	名詞	
ちゃけい	茶経	固有名詞	
ちゃけいたん	茶鶏蛋	名詞	
ちゃげい	茶芸	名詞	
ちゃげい	茶藝	名詞	
ちゃげいかん	茶芸館	名詞	
ちゃげいかん	茶藝館	名詞	
ちゃこ	茶壷	名詞	
ちゃこう	茶皇	名詞	
ちゃことば	茶言葉	固有名詞	
ちゃご	茶荷	名詞	
ちゃし	茶師	名詞	
ちゃしゅうちゃらく	茶趣茶樂	固有名詞	
ちゃしょ	茶書	名詞	
ちゃしょう	茶廠	名詞	
ちゃしん	茶神	名詞	
ちゃじゅ	茶樹	名詞	
ちゃじゅう	茶汁	名詞	
ちゃじゅおう	茶樹王	名詞	
ちゃじる	茶汁	名詞	
ちゃじん	茶神	名詞	
ちゃせい	茶精	名詞	
ちゃせん	茶船	名詞	
ちゃせん	茶磚	名詞	
ちゃそ	茶疏	名詞	
ちゃそう	茶倉	名詞	
ちゃそう	茶荘	名詞	
ちゃそく	茶則	名詞	
ちゃそば	茶そば	名詞	
ちゃちゃちゃさろん	Cha Cha Cha Salon	固有名詞	
ちゃちゅうかんぼほんのう	茶中間母本農	固有名詞	
ちゃちゅうざら	茶中皿	名詞	
ちゃちょう	茶銚	名詞	
ちゃっこう	着香	名詞	
ちゃっぺい	茶碗	名詞	
ちゃつう	茶通	名詞	
ちゃとう	茶刀	名詞	
ちゃとう	茶湯	名詞	
ちゃのき	茶の木	固有名詞	
ちゃのみち	茶の道	名詞	
ちゃのゆ	茶湯	名詞	
ちゃはい	茶杯	名詞	
ちゃばこうえきかい	茶葉交易会	名詞	
ちゃばこどう	茶馬古道	名詞	
ちゃばさみ	茶挟	名詞	
ちゃばち	茶盂	名詞	
ちゃばん	茶盤	名詞	
ちゃひつ	茶櫃	名詞	
ちゃびつ	茶櫃	名詞	
ちゃぴん	茶餅	名詞	
ちゃふー	茶壷	名詞	
ちゃふう	茶壷	名詞	
ちゃふう	茶風	固有名詞	
ちゃぶね	茶船	名詞	
ちゃへい	茶餅	名詞	
ちゃぺい	茶碗	名詞	
ちゃもち	茶餅	名詞	
ちゃゆこじだん	茶湯故事談	固有名詞	
ちゃよい	茶酔い	名詞	
ちゃようこうえきかい	茶葉交易会	名詞	
ちゃりょう	茶量	名詞	
ちゃろう	茶楼	名詞	
ちゃわいちゃ	茶外茶	名詞	
ちゃんうぇい	薔薇	名詞	
ちゅうごくしゅ	中国種	名詞	
ちゅうごくちゃれいほう	中国茶礼法	名詞	
ちゅうし	虫屎	名詞	
ちゅうちゃ	虫茶	名詞	
ちゅうふん	虫糞	名詞	
ちゅうようしゅ	中葉種	名詞	
ちゅんしゅん	陳醇	名詞	
ちゅんてぃー	群体	名詞	
ちゅんてぃーしゃん	群体香	名詞	
ちょうしょうせい	長炒青	名詞	
ちょうとっきゅう	超特級	名詞	
ちょうはい	條杯	名詞	
ちょうれんか	蝶恋花	名詞	
ちらんちゃ	知覧茶	名詞	
ちんか	陳香	名詞	
ちんこう	陳香	名詞	
ちんしゃん	清香	名詞	
ちんしゃんふぁーろう	清香花楼	名詞	
ちんすこー	珍楚糕	名詞	
ちんすこう	ちんすこう	名詞	
ちんすこう	珍楚糕	名詞	
ちんぞう	珍蔵	名詞	
ちんちゃ	青茶	名詞	
ちんねん	陳年	名詞	
ちんび	珍眉	名詞	
ちんぴ	オレンジピール	名詞	
ちんぴ	陳皮	名詞	
ちんぴん	青餅	名詞	
ちんほう	陳醇	名詞	
ちんろう	青楼	名詞	
つぁんほん	棗紅	名詞	
つぃーゆい	翠玉	名詞	
ついしょう	遂昌	名詞	
つうてんか	通天香	名詞	
つうてんこう	通天香	名詞	
つえちゃ	津江茶	名詞	
つかさみどり	司みどり	固有名詞	
つがるりんご	津軽りんご	固有名詞	
つきがせちゃ	月ヶ瀬茶	名詞	
つけものちゃ	漬物茶	名詞	
つちやまちゃ	土山茶	名詞	
つのはい	角杯	名詞	
つめちゃ	詰茶	名詞	
つゆひかり	つゆひかり	固有名詞	
つるれいし	蔓茘枝	名詞	
てあにん	THEANINE	名詞	
てあにん	テアニン	名詞	
てあふらびん	THEAFLAVINS	名詞	
てあふらびん	テアフラビン	名詞	
てあぶらうん	THEABROWN	名詞	
てあぶらうん	テアブラウン	名詞	
てあるびじん	THEARUBIGINS	名詞	
てあるびじん	テアルビジン	名詞	
てぃーこじー	ティーコジー	名詞	
てぃーすぷーん	Tea Spoon	固有名詞	
てぃあんしゃん	甜香	名詞	
てぃえぐわんいん	鉄観音	名詞	
てぃえろーはん	鉄羅漢	名詞	
てぃえんみー	甜蜜	名詞	
てぃぐわんいん	鉄観音	名詞	
てぃざーぬどばれー	ティザーヌ ド バレー	固有名詞	
てぃやおべい	條杯	名詞	
てぃゆーる	ティユール	固有名詞	
ていすてぃんぐかっぷ	評鑑杯	名詞	
ていらん	提籃	名詞	
ておふぃりん	THEOPHYLLINE	名詞	
ておふぃりん	テオフィリン	名詞	
ておぶろみん	THEOBROMINE	名詞	
ておぶろみん	テオブロミン	名詞	
てっかんのん	鉄観音	名詞	
てっかんのん	鐡観音	名詞	
てっかんのんしゅ	鉄観音種	名詞	
てっきゅふー	掇球壺	名詞	
てっけいらん	鉄桂蘭	名詞	
てっけいらん	鐵桂蘭	名詞	
てっぺい	鉄餅	名詞	
てつかんのん	鉄観音	名詞	
てつかんのん	鐡観音	名詞	
てつけいらん	鉄桂蘭	名詞	
てつけいらん	鐵桂蘭	名詞	
てつらかん	鉄羅漢	固有名詞	
てつらかん	鐡羅漢	名詞	
てとらぱっく	テトラパック	名詞	
てびねり	手びねり	名詞	
てびねり	手捻り	名詞	
てもみ	手揉み	名詞	
てらかわわせ	寺川早生	固有名詞	
てんか	天華	名詞	
てんか	添花	名詞	
てんか	甜香	名詞	
てんかこくせん	天華谷尖	名詞	
てんぎょく	天玉	名詞	
てんこう	甜香	名詞	
てんさん	天山	名詞	
てんざん	天山	名詞	
てんしゅ	展趣	名詞	
てんしょく	転色	名詞	
てんしんがん	天心岩	名詞	
てんじゅん	甜純	名詞	
てんせん	天孅	名詞	
てんちゃ	甜茶	名詞	
てんちゃ	碾茶	名詞	
てんちゃけんこうし	甜茶懸鈎子	名詞	
てんふーめいちゃ	天府茗茶	固有名詞	
てんぷるおぶへぶん	TEMPLE OF HEAVEN	名詞	
てんぷるおぶへぶん	テンプルオブヘブン	名詞	
てんみつ	甜蜜	名詞	
てんみょう	展みょう	固有名詞	
てんむ	天霧	名詞	
てんもく	天目	名詞	
てんり	天梨	名詞	
てんりゅうちゃ	天竜茶	名詞	
てんりょく	滇緑	名詞	
てんれん	天仁	固有名詞	
てんれんめいちゃ	天仁銘茶	固有名詞	
てんろ	天廬	名詞	
てんろこうへん	天露香片	名詞	
でぃえれんふぁー	蝶恋花	名詞	
でぃんほん	滇紅	固有名詞	
できらたーぜ	デキラターゼ	名詞	
でんとう	傳統	名詞	
といん	都均	名詞	
といんもうせん	都匀毛尖	名詞	
とうか	桃花	名詞	
とうか	桃香	名詞	
とうがらしうーろん	唐辛子烏龍	固有名詞	
とうがわのむかし	塔川の昔	固有名詞	
とうきょうさやまちゃ	東京狭山茶	名詞	
とうくんろん	桐君録	固有名詞	
とうこう	稲香	名詞	
とうこう	桃香	名詞	
とうこうばい	桃紅梅	名詞	
とうさい	豆彩	名詞	
とうさぼう	陶作坊	固有名詞	
とうしゅんばんちゃ	冬春番茶	名詞	
とうじょう	桐城	名詞	
とうすいかし	頭水夏仔	名詞	
とうせい	冬青	名詞	
とうちゃ	冬茶	名詞	
とうちゃ	闘茶	名詞	
とうちゃ	沱茶	名詞	
とうちょう	凍頂	固有名詞	
とうび	桃美	名詞	
とうへんちゃ	冬片茶	名詞	
とうようとうじびじゅつかん	東洋陶磁美術館	固有名詞	
とうりゅう	騰龍	名詞	
ときお	TOKIO	固有名詞	
とくう	得雨	名詞	
とくうかっちゃ	得雨活茶	名詞	
とくそう	特早	名詞	
とこなめやき	常滑焼き	名詞	
とさちゃ	土佐茶	名詞	
とさばんちゃ	土佐番茶	名詞	
としゅ	吐珠	名詞	
とじゅ	吐珠	名詞	
とっけい	尖形	名詞	
とつけい	尖形	名詞	
とどうのしろ	菟道の白	固有名詞	
とろびん	吐ろ瓶	名詞	
とろりんちゃ	とろりん茶	固有名詞	
とんけい	屯渓	名詞	
とんりょく	屯緑	名詞	
どぅーやんまおじゃん	都匀毛尖	名詞	
どうちゃ	沱茶	名詞	
どくだみちゃ	蕺茶	名詞	
どくだめ	毒溜め	名詞	
どんか	嫩香	名詞	
どんこう	嫩香	名詞	
どんでぃん	凍頂	固有名詞	
どんふぁん	東方	名詞	
どんふぁんめいれん	東方美人	名詞	
ないうぇい	奶味	名詞	
なぐさのね	名草の音	固有名詞	
なごみのむかし	和みの昔	固有名詞	
なたねかす	菜種粕	名詞	
なつちゃ	夏茶	名詞	
ななこ	七子	名詞	
なましょく	生食	名詞	
なまちゃ	生茶	名詞	
なりの	成里乃	固有名詞	
なんきんうかちゃ	南京雨花茶	固有名詞	
なんさん	南山	名詞	
なんざん	南山	名詞	
なんし	軟枝	名詞	
なんだはくごう	南糯白毫	名詞	
なんぬおばいはお	南糯白毫	名詞	
なんばん	南蠻	名詞	
なんぶちゃ	南部茶	名詞	
なんぼうろく	南方録	固有名詞	
なんぽうろく	南方録	固有名詞	
にがあじ	苦味	名詞	
にくけい	肉桂	名詞	
にしおてんちゃ	西尾碾茶	名詞	
にじゅうしせっき	二十四節気	名詞	
にじゅうしせつき	二十四節気	名詞	
にじりぐち	にじり口	名詞	
にすいちゃ	二水茶	名詞	
にちげったん	日月潭	名詞	
にちげつ	日月	名詞	
にちげつたん	日月潭	名詞	
にちせん	日錢	名詞	
にっき	シナモン	名詞	
にっき	肉桂	名詞	
にっけい	肉桂	名詞	
にっこういちょう	日光萎凋	名詞	
にっしき	日式	名詞	
にばんちゃ	二番茶	名詞	
にほうちゃ	二邦茶	名詞	
にゅうせん	乳扇	名詞	
にゅうちょう	乳丁	名詞	
にゅうはくじ	乳白磁	名詞	
にょく	茹苦	名詞	
にょくちゃ	茹苦茶	名詞	
にんじんうーろん	人参烏龍	名詞	
ぬまづちゃ	沼津茶	名詞	
ねいか	寧夏	名詞	
ねえさん	小姐さん	名詞	
ねえさん	大姐さん	名詞	
ねろりどーる	NEROLIDOL	名詞	
ねろりどーる	ネロリドール	名詞	
ねんしゃん	嫩香	名詞	
のうお	納汚	名詞	
のうこう	濃香	形容詞	
のうみ	濃味	名詞	
のうりんすいさんだいじんしょう	農林水産大臣賞	名詞	
のお	納汚	名詞	
のぎめ	禾目	名詞	
のばら	ローズヒップ	名詞	
のんいん	音韻	名詞	
のんうぇい	濃味	名詞	
のんか	嫩香	名詞	
のんこう	嫩香	名詞	
はいしゃんふぁーゆん	海上花園	名詞	
はいばらちゃ	榛原茶	名詞	
はおしゃん	毫香	名詞	
はがきのき	ハガキの木	名詞	
はがきのき	葉書樹	名詞	
はくが	白芽	名詞	
はくがきらん	白芽奇蘭	固有名詞	
はくきらん	白奇蘭	名詞	
はくけいかん	白鶏冠	名詞	
はくごう	ペコ	名詞	
はくごう	白毫	名詞	
はくごうぎんしん	白毫銀針	名詞	
はくしゃくちゃ	アールグレイ	名詞	
はくたんか	白瑞香	名詞	
はくたんこう	白瑞香	名詞	
はくちゃ	白茶	名詞	
はくとううーろん	白桃烏龍	固有名詞	
はくぼたん	白牡丹	名詞	
はくもう	白毛	名詞	
はくもうこう	白毛猴	名詞	
はくよう	白葉	名詞	
はくようたんそう	白葉単叢	名詞	
はくりゅうじゅ	白龍珠	名詞	
はくりん	白琳	名詞	
はすちゃ	蓮茶	名詞	
はちのすこう	蜂巣坑	名詞	
はっきらん	白奇蘭	名詞	
はっけいかん	白鶏冠	名詞	
はっせん	八仙	名詞	
はっせんじかい	八仙辻海	名詞	
はっぽう	八宝	名詞	
はっぽうちゃ	八宝茶	名詞	
はとぐち	鳩口	名詞	
はとむぎ	鳩麦	名詞	
はないれ	花入	名詞	
はながたぼん	花形盆	名詞	
はなちゃ	花茶	名詞	
はなび	華火	固有名詞	
はにーぶっしゅ	蜜樹	名詞	
はぶ	波布	名詞	
はぶそう	波布草	名詞	
はぶちゃ	波布茶	名詞	
はり	玻璃	名詞	
はるちゃ	春茶	名詞	
はるぽろぽろ	春ぽろぽろ	固有名詞	
はればれ	晴ればれ	固有名詞	
はんがんちゃ	半岩茶	名詞	
はんつぼ	潘壺	名詞	
はんてん	半天	名詞	
はんてんよう	半天腰	名詞	
はんてんよう	半天妖	名詞	
はんでぃーくーらー	ハンディークーラー	名詞	
はんはっこう	半発酵	名詞	
ばーばお	八宝	名詞	
ばいかい	玫瑰	名詞	
ばいかう	梅家塢	名詞	
ばいかお	梅家塢	名詞	
ばいかひつだん	梅花筆談	名詞	
ばいけう	梅家塢	名詞	
ばいけお	梅家塢	名詞	
ばいせん	梅占	名詞	
ばいせんまめまめちゃ	焙煎豆々茶	固有名詞	
ばいちゃ	白茶	名詞	
ばいちゃ	焙茶	名詞	
ばたーちゃ	バター茶	名詞	
ばたばたちゃ	バタバタ茶	名詞	
ばていけいがま	馬蹄形窯	名詞	
ばにら	香草	名詞	
ばらこう	馬拉糕	名詞	
ばんかけんきょく	盤花巻曲	名詞	
ばんかんこう	晩甘喉	名詞	
ばんてぃえんやお	半天妖	名詞	
ぱい	白	名詞	
ぱいいぇーだんつぉん	白葉単叢	名詞	
ぱいおう	白亳	名詞	
ぱいじー	白菊	名詞	
ぱいちゃ	白茶	名詞	
ぱいなっぷる	鳳梨	名詞	
ぱいはお	白毫	名詞	
ぱいはおいんぢぇん	白毫銀針	名詞	
ぱいむーたん	白牡丹	名詞	
ぱいむーだん	白牡丹	名詞	
ぱいろんじゅ	白龍珠	名詞	
ぱいろんじん	白龍井	名詞	
ぱおじょん	包種	名詞	
ぱおろー	包揉	名詞	
ひうがちゃ	日向茶	名詞	
ひか	火香	名詞	
ひだいかいちゃ	肥大海茶	名詞	
ひつまぶし	ひつまぶし	名詞	
ひとあな	一穴	名詞	
ひびきはい	響杯	名詞	
ひまらやん	HIMALAYAN	形容詞	
ひまらやん	ヒマラヤン	形容詞	
ひめちゃでん	姫茶伝	固有名詞	
ひめりんご	姫林檎	名詞	
ひもづくり	ひも作り	名詞	
ひもづくり	紐作り	名詞	
ひゃくさいか	百歳香	名詞	
ひゃくじょうがん	百丈岩	名詞	
ひゃくねんろうそう	百年老叢	名詞	
ひやまちゃ	檜山茶	名詞	
ひょういつはい	飄逸杯	名詞	
ひょうか	飄香	名詞	
ひょうこ	俵壺	名詞	
ひょうこう	飄香	名詞	
ひらかご	平籠	名詞	
ひらみれもん	シークヮーサー	名詞	
ひらみれもん	平実檸檬	名詞	
ひんぴょうしゃ	品評者	名詞	
ひんめいはい	品茗杯	名詞	
びはっこう	微発酵	名詞	
びゃくごう	白毫	名詞	
びゃくごうぎんしん	白毫銀針	名詞	
びゃっこ	白虎	名詞	
びわえん	琵琶園	固有名詞	
びわのは	枇杷の葉	名詞	
びんしき	瓶敷き	名詞	
びんなんうーろん	閩南烏龍	名詞	
びんぺいうーろん	閩北烏龍	名詞	
びんほくうーろん	閩北烏龍	名詞	
びんぽくうーろん	閩北烏龍	名詞	
ぴーろーちゅん	碧螺春	名詞	
ぴーろーつん	碧螺春	名詞	
ぴるちゅん	碧螺春	名詞	
ぴるつん	碧螺春	名詞	
ぴろちゅん	碧螺春	名詞	
ぴろつん	碧螺春	名詞	
ぴんいん	舞獅	名詞	
ぴんちゃ	餅茶	名詞	
ぴんりん	坪林	名詞	
ふー	壷	名詞	
ふぁーたい	華泰	固有名詞	
ふぁーたいちゃそう	華泰茶荘	固有名詞	
ふぁしゃん	花香	名詞	
ふぁん	黄	名詞	
ふぁんかんのん	黄観音	名詞	
ふぁんさん	黄山	名詞	
ふぁんしゃお	黄小	名詞	
ふぁんじんぐい	黄金桂	名詞	
ふぁんだー	黄大	名詞	
ふぁんちゃ	黄茶	名詞	
ふぁんや	黄芽	名詞	
ふあたいちゃそう	華泰茶荘	固有名詞	
ふあちゃ	花茶	名詞	
ふうせいどう	風清堂	固有名詞	
ふうび	風眉	名詞	
ふぇん	粉	名詞	
ふぇんふぁんたんつぉん	鳳凰単叢	名詞	
ふかむし	深蒸し	名詞	
ふかむしちゃ	深蒸し茶	名詞	
ふくうん	福雲	名詞	
ふくさ	袱紗	名詞	
ふくさばさみ	袱紗挟み	名詞	
ふくじゅう	復揉	名詞	
ふくずみちゃ	福住茶	名詞	
ふくせんちゃ	茯磚茶	名詞	
ふくてい	福鼎	名詞	
ふくばい	復焙	名詞	
ふくろいちゃ	袋井茶	名詞	
ふけんてん	不見天	名詞	
ふしんあん	不審菴	固有名詞	
ふじえだちゃ	藤枝茶	名詞	
ふじかおり	藤かおり	固有名詞	
ふたおき	蓋置	名詞	
ふたまくら	蓋枕	名詞	
ふだ	普陀	名詞	
ふだぶっちゃ	普陀佛茶	名詞	
ふだぶつ	普陀佛	名詞	
ふちしゅん	不知春	名詞	
ふちょうちゃ	富丁茶	名詞	
ふゆちゃ	冬茶	名詞	
ふゆはるばんちゃ	冬春番茶	名詞	
ふらんぼわーず	覆盆子	名詞	
ふるりーふ	全葉	名詞	
ふればりー	フレバリー	名詞	
ふろうさん	布朗山	名詞	
ふろさきびょうぶ	風炉先屏風	名詞	
ふんさい	粉彩	名詞	
ぶい	武夷	名詞	
ぶいがんちゃ	武夷岩茶	固有名詞	
ぶいちゃ	武夷茶	名詞	
ぶくぶくちゃ	ぶくぶく茶	名詞	
ぶじちゃ	富士茶	名詞	
ぶっしゅ	佛手	名詞	
ぶっしゅかん	ベルガモット	名詞	
ぶっしゅかん	佛手柑	名詞	
ぶっちゃ	佛茶	名詞	
ぶつら	物羅	名詞	
ぶどうか	葡萄香	名詞	
ぶどうこう	葡萄香	名詞	
ぶぶこうしょう	歩歩高昇	名詞	
ぶよう	武陽	名詞	
ぶるーべりー	藍莓	名詞	
ぶろーくん	碎葉	名詞	
ぶんくん	文君	名詞	
ぶんこう	聞香	名詞	
ぶんこうはい	聞香杯	名詞	
ぶんさんほうしゅ	文山包種	名詞	
ぶんぜん	分前	名詞	
ぶんぜんちゃ	分前茶	名詞	
ぷーあーる	普洱	名詞	
ぷーある	普洱	名詞	
ぷーちょん	包種	名詞	
ぷーらん	布郎	名詞	
ぷあーる	普洱	名詞	
ぷちちゅん	不知春	名詞	
へいすいじゅ	平水珠	名詞	
へいせい	平正	名詞	
へいちゃ	黒茶	名詞	
へいちゃ	餅茶	名詞	
へきこう	碧口	名詞	
へきらしゅん	碧螺春	名詞	
へきりょく	碧緑	名詞	
へんけい	片形	名詞	
へんけい	扁形	名詞	
へんこ	扁壺	名詞	
へんしょうせい	扁炒青	名詞	
へんしょうらん	扁井欄	名詞	
へんしょうらんふう	扁井欄壷	名詞	
へんせい	返青	名詞	
へんちゃ	片茶	名詞	
べいちゃ	餅茶	名詞	
べいどう	北斗	名詞	
べにいずみふよう	紅出水芙蓉	名詞	
べにうーろん	紅烏龍	名詞	
べにぼたん	紅牡丹	名詞	
べるえぽっく	ベルエポック	固有名詞	
べるがもっと	佛手柑	名詞	
ぺいちゃ	餅茶	名詞	
ぺこ	PEKOE	名詞	
ぺこ	ペコ	名詞	
ぺこ	白毫	名詞	
ほううぇい	回味	名詞	
ほうおうたんそう	鳳凰単叢	名詞	
ほうくい	猴魁	名詞	
ほうこふー	倣古壷	名詞	
ほうしゅ	包種	名詞	
ほうしゅちゃ	包種茶	名詞	
ほうしゅん	鳳春	固有名詞	
ほうじちゃ	焙じ茶	名詞	
ほうじちゃふるーつ	焙じ茶フルーツ	固有名詞	
ほうじゅう	包揉	名詞	
ほうそうげ	宝相華	名詞	
ほうちゃ	方茶	名詞	
ほうびん	宝瓶	名詞	
ほうびん	泡瓶	名詞	
ほうらい	宝莱	名詞	茶筅用語
ほうれんとう	宝蓮灯	名詞	
ほくと	北斗	名詞	
ほくといちごう	北斗一号	名詞	
ほけんちゃ	保健茶	名詞	
ほしのみどり	星野緑	固有名詞	
ほっぽうびじん	北方美人	固有名詞	
ほらふきちゃ	ほらふき茶	名詞	
ほりいしき	堀井式	名詞	
ほりいしちめいえん	堀井七茗園	固有名詞	
ほんうーろん	紅烏龍	名詞	
ほんざんちゃ	本山茶	名詞	
ほんしゃんぴー	紅香螺	名詞	
ほんず	本簀	名詞	
ほんずおおい	本簀覆い	名詞	
ほんせい	烘青	名詞	
ほんそうもうもく	本草綱目	固有名詞	
ほんぞうこうもく	本草綱目	名詞	
ほんちゃ	紅茶	名詞	
ほんちん	烘青	名詞	
ほんぺい	烘焙	名詞	
ほんみれい	紅美麗	名詞	
ほんむーたん	紅牡丹	名詞	
ほんめいりー	紅美麗	名詞	
ほんゆい	紅玉	名詞	
ほんりー	パイナップル	名詞	
ほんりー	鳳梨	名詞	
ほんりーうーろん	鳳梨烏龍	固有名詞	
ほんりーすー	鳳梨酥	名詞	
ほんりす	鳳梨酥	名詞	
ほんるお	紅螺	名詞	
ほんわか	本和香	名詞	
ぼーんちゃいな	骨瓷	名詞	
ぼうかいうんむ	望海雲霧	名詞	
ぼうちゃ	棒茶	名詞	
ぼうふう	膨風	名詞	
ぼうぼうちゃ	暴暴茶	名詞	
ぼくが	墨芽	名詞	
ぼくこう	墨江	名詞	
ぼくでい	墨泥	名詞	
ぼじゅ	母樹	名詞	
ぼっこう	墨江	名詞	
ぽうちゃ	緊茶	名詞	
ぽうれい	緊壓	名詞	
ぽうれいちゃ	緊壓茶	名詞	
ぽんふう	椪風	名詞	
ぽんふぉん	膨風	名詞	
ぽんふぉん	椪風	名詞	
まーらいこー	馬拉糕	名詞	
まーらいこう	馬拉糕	名詞	
まいかい	玫瑰	名詞	
まいらん	米蘭	名詞	
まいらんちゃ	米蘭茶	名詞	
まおじゃん	毛尖	名詞	
まおふぇん	毛峰	名詞	
まさーらー	マサーラー	名詞	
まざーつりー	マザーツリー	名詞	
ますかっと	麝香葡萄	名詞	
まっちゃいりげんまいちゃ	抹茶入り玄米茶	名詞	
まっちゃわん	抹茶碗	名詞	
まつかぜ	松風	固有名詞	
まつちゃ	末茶	名詞	
まつばり	松針	名詞	
まつり	祭	固有名詞	
まつりか	茉莉花	名詞	
まつりせんとう	茉莉仙桃	名詞	
まつりせんにょ	茉莉仙女	名詞	
まつりばな	茉莉花	名詞	
まて	馬黛	名詞	
まめちゃ	豆茶	名詞	
まらこう	馬拉糕	名詞	
まりきんころ	茉莉金葫芦	名詞	
まりこ	摩利子	固有名詞	
まりこうだいきょう	茉莉康乃馨	名詞	
まりしんおう	茉莉針王	名詞	
まりろんじゅ	茉莉龍珠	名詞	
まるはちせいちゃじょう	丸八製茶場	固有名詞	
まんご	芒果	名詞	
まんごー	芒果	名詞	
まんてぃえんほんしゅんたお	満天紅仙桃	名詞	
まんどころちゃ	政所茶	名詞	
まんふう	満富	名詞	
みーらん	蜜蘭	名詞	
みーらんしゃん	蜜蘭香	名詞	
みあん	MIANG	名詞	
みあん	ミアン	名詞	
みえりょくほう	三重緑萌	固有名詞	
みかわちゃ	三河茶	名詞	
みしょう	実生	名詞	
みずつぎ	水注	名詞	
みぞべちゃ	みぞべ茶	名詞	
みっか	蜜香	名詞	
みっこう	蜜香	名詞	
みっとうか	蜜桃香	名詞	
みっとうか	蜜糖香	名詞	
みっとうこう	蜜桃香	名詞	
みっとうこう	蜜糖香	名詞	
みつあん	密庵	名詞	
みつか	蜜香	名詞	
みつこう	蜜香	名詞	
みつじゅ	蜜樹	名詞	
みつとうか	蜜桃香	名詞	
みつらんか	蜜蘭香	名詞	
みつらんこう	蜜蘭香	名詞	
みどりちゃ	緑茶	名詞	
みどりぼたん	緑牡丹	名詞	
みのやき	美濃焼	名詞	
みまさかちゃ	美作茶	名詞	
みやこのじょうちゃ	都城茶	名詞	
みやざきばんちゃ	宮崎番茶	名詞	
みやのじょうちゃ	宮之城茶	名詞	
みょうきあん	妙喜庵	名詞	
みんじぇんすーじーちゅん	名間四季春	名詞	
みんじぇんつぃーゆい	名間翠玉	名詞	
みんぜん	明前	名詞	
みんちぇん	明前	名詞	
みんと	薄菏	名詞	
みんなんうーろん	閩南烏龍	名詞	
みんぺいうーろん	閩北烏龍	名詞	
みんほくうーろん	閩北烏龍	名詞	
みんぽくうーろん	閩北烏龍	名詞	
むーじゃ	木柵	名詞	
むーじゃてぃえぐあんいん	木柵鉄観音	名詞	
むーたん	牡丹	名詞	
むしごけ	ムシゴケ	名詞	
むしごけ	虫苔	名詞	
むしゃくけんえざんじせきせんすい	無錫県恵山寺石泉水	名詞	
むひつせいか	夢筆生花	名詞	
むらかみちゃ	村上茶	名詞	
めあと	目跡	名詞	
めいえん	茗園	名詞	
めいかんしきしゅん	名間四季春	名詞	
めいかんすいぎょく	名間翠玉	名詞	
めいくい	玫瑰	名詞	
めいぐい	めいぐい	名詞	
めいぐい	メイグイ	名詞	
めいこうかく	茗香閣	固有名詞	
めいしゃちゃかん	梅舎茶館	固有名詞	
めいしゅ	名種	名詞	
めいじあうー	梅家塢	名詞	
めいちゃ	名茶	名詞	
めいちゃ	銘茶	名詞	
めいちゃ	茗茶	名詞	
めいびん	梅瓶	名詞	
めいれん	美人	名詞	
めちゃ	芽茶	名詞	
めんぜん	明前	名詞	
めんぜんちゃ	明前茶	名詞	
めんでぃんがんるー	蒙頂甘露	名詞	
めんとり	面取	名詞	
もーゔ	MAUVE	固有名詞	
もーゔ	モーヴ	固有名詞	
もーりー	茉莉	名詞	
もーりーちーしぇんにー	茉莉七仙女	名詞	
もーりーちゅんはお	茉莉春毫	固有名詞	
もーりすめせっげ	モーリス・メセッゲ	人名	
もうかい	毛蟹	名詞	
もうぎん	毛銀	名詞	
もうしちゃ	母子茶	名詞	
もうせん	毛尖	名詞	
もうちゃ	毛茶	名詞	
もうちょうかんろ	蒙頂甘露	名詞	
もうほう	毛峰	名詞	
もかんこうが	莫干黄芽	名詞	
もくさく	木柵	名詞	
ものうちゃ	桃生茶	名詞	
もりえん	森園	固有名詞	
もんおう	悶黄	名詞	
もんこう	聞香	名詞	
もんこう	悶黄	名詞	
もんこうはい	聞香杯	名詞	
やおちん	揺青	名詞	
やぎゅうちゃ	柳生茶	名詞	
やくそうちゃ	薬草茶	名詞	
やくようちゃ	薬用茶	名詞	
やしろちゃ	やしろ茶	名詞	
やせいいちようちゃ	野生一葉茶	名詞	
やせいくちょうちゃ	野生苦丁茶	名詞	
やせいちゃ	野生茶	名詞	
やせいのき	野生の樹	固有名詞	
やぶきたちゃ	やぶきた茶	名詞	
やべちゃ	矢部茶	名詞	
やほう	野放	名詞	
やまぐちちゃ	山口茶	名詞	
やまぞえちゃ	山添茶	名詞	
やまちゃ	山茶	名詞	
やまとちゃ	大和茶	名詞	
やまのいぶき	山の息吹	固有名詞	
やまみちぼん	山道盆	名詞	
やめちゃ	八女茶	名詞	
やらいこう	夜来香	名詞	
やわえだ	軟枝	名詞	
やんふう	養壷	名詞	
ゆーふん	福雲	名詞	
ゆいしゃん	余香	名詞	
ゆうか	幽香	名詞	
ゆうかか	柚花香	名詞	
ゆうかこう	柚花香	名詞	
ゆうきこうちゃ	有機紅茶	名詞	
ゆうこう	幽香	名詞	
ゆうちゃ	遊茶	固有名詞	
ゆうひん	優品	名詞	
ゆうふうのむかし	雄風の昔	固有名詞	
ゆきちゃ	雪茶	名詞	
ゆざまし	湯冷まし	名詞	
ゆざんさぼう	遊山茶訪	固有名詞	
ゆずちゃ	柚子茶	名詞	
ゆずちゃ	柚茶	名詞	
ゆたかみどり	豊緑	固有名詞	
ゆりか	百合花	名詞	
ゆりばな	百合花	名詞	
ゆんふぇん	雲峰	名詞	
よいごし	宵越し	名詞	
よいばな	宵花	名詞	
ようきく	洋菊	名詞	
ようきくちゃ	洋菊茶	名詞	
ようぎく	洋菊	名詞	
ようせい	揺青	名詞	
ようせんせつが	陽羨雪芽	名詞	
ようつぼ	養壷	名詞	
ようふう	養壷	名詞	
ようへん	曜変	名詞	
ようへん	窯変	名詞	
ようへん	耀変	名詞	
ようへん	燿変	名詞	
ようやんせつが	陽羨雪芽	名詞	
よか	余香	名詞	
よこう	余香	名詞	
よしず	葭簀	名詞	
よんだいいわちゃ	四大岩茶	名詞	
よんだいがんちゃ	四大岩茶	名詞	
よんだいめいそう	四大名叢	名詞	
よんばんちゃ	四番茶	名詞	
らいしん	雷針	名詞	
らいち	茘枝	名詞	
らいち	荔枝	名詞	
らかんか	羅漢果	名詞	
らかんかちゃ	羅漢果茶	名詞	
らく	良久	名詞	
らちょう	螺釘	名詞	
らちょうけい	螺釘形	名詞	
らてい	螺釘	名詞	
らていけい	螺釘形	名詞	
らふま	羅布麻	名詞	
らふまちゃ	羅布麻茶	名詞	
らぷさんすーちょん	正山小種	固有名詞	
らべんだー	薰衣草	名詞	
らぺそー	ラペソー	名詞	
らんいちご	藍莓	名詞	
らんか	蘭香	名詞	
らんかがん	蘭香岩	名詞	
らんきじん	蘭貴人	名詞	
らんこう	蘭香	名詞	
らんこうがん	蘭香岩	名詞	
らんしゃん	蘭香	名詞	
らんそうこう	瀾滄江	名詞	
らんそうこうちゃせん	瀾滄江茶磚	名詞	
らんばい	藍莓	名詞	
りくう	陸羽	人名	
りなろーる	LINALOOL	名詞	
りなろーる	リナロール	名詞	
りゅーむーたん	緑牡丹	名詞	
りゅうい	竜井	名詞	
りゅうい	龍井	名詞	
りゅうがん	龍眼	名詞	
りゅうがんこう	龍眼香	名詞	
りゅうざんうんごう	龍山雲毫	名詞	
りゅうしゅ	龍珠	名詞	
りゅうせんゆう	龍泉釉	名詞	
りゅうぜつ	雀舌	名詞	
りゅうちゃ	緑茶	名詞	
りゅうふう	龍鳳	名詞	
りゅうほう	龍鳳	名詞	
りゅうほうきょう	龍鳳峽	名詞	
りょうごうちちゃ	両河内茶	名詞	
りょうたんちゃ	両丹茶	名詞	
りょうはく	凌白	名詞	
りょくえん	緑苑	固有名詞	
りょくせつ	緑雪	名詞	
りょくちゃうめしゅ	緑茶梅酒	名詞	
りょくでい	緑泥	名詞	
りょくへきこうちゃえん	緑碧紅茶苑	固有名詞	
りょくぼたん	緑牡丹	名詞	
りょくもうぎんしん	緑豪銀針	固有名詞	
りんご	苹果	名詞	
りんご	蘋果	名詞	
りんしゃんしー	杉林渓	名詞	
るーしゃん	乳扇	名詞	
るーちゃ	緑茶	名詞	
るいぼす	路易波斯	名詞	
るばーぶ	RHUBARB	名詞	
るばーぶ	ルバーブ	名詞	
るぴしあ	LUPICIA	固有名詞	
るぴしあ	緑碧紅茶苑	固有名詞	
れいし	ライチ	名詞	
れいし	霊芝	名詞	
れいし	茘枝	名詞	
れいちゃ	冷茶	名詞	
れいちゃ	擂茶	名詞	
れもんぐさ	檸檬草	名詞	
れもんぐらす	檸檬草	名詞	
れもんそう	檸檬草	名詞	
れんか	恋歌	名詞	
れんか	蓮花	名詞	
れんげ	蓮花	名詞	
れんしん	蓮芯	名詞	
れんしんちゃ	蓮芯茶	名詞	
れんちゃ	蓮茶	名詞	
ろーずひっぷ	野薔薇	名詞	
ろーにぇん	揉捻	名詞	
ろうおうちゃ	老鷹茶	名詞	
ろうくんび	老君眉	名詞	
ろうすいせん	老水仙	名詞	
ろうそう	老叢	名詞	
ろうだちゃ	老沱茶	名詞	
ろうちく	老竹	名詞	
ろうちゃ	老茶	名詞	
ろうばーちゃ	老婆茶	名詞	
ろうばちゃ	老婆茶	名詞	
ろうぼくこう	老木香	名詞	
ろうようちゃ	老鷹茶	名詞	
ろくあん	六安	名詞	
ろくあんかへん	六安瓜片	名詞	
ろくがつしろ	六月白	名詞	
ろくがつはく	六月白	名詞	
ろくげつはく	六月白	名詞	
ろくしんけっちゃ	鹿心血茶	名詞	
ろくしんけつちゃ	鹿心血茶	名詞	
ろくしんちゃ	鹿心茶	名詞	
ろくだいちゃるい	六大茶類	名詞	
ろくほうちゃ	六堡茶	名詞	
ろくほちゃ	六堡茶	名詞	
ろくらくさぼう	六楽茶房	固有名詞	
ろくろづくり	轆轤作り	名詞	
ろざんうんむ	盧山雲霧	固有名詞	
ろざんこうおうこくすいれん	盧山康王谷水簾	名詞	
ろっぽうちゃ	六堡茶	名詞	
ろびじん	虞美人	名詞	
ろんい	龍井	名詞	
ろんがんしゃん	龍眼香	名詞	
ろんぐい	肉桂	名詞	
ろんじゅ	龍珠	名詞	
ろんじん	竜井	名詞	
ろんじん	龍井	名詞	
ろんじんこうちゃ	龍井紅茶	名詞	
ろんじんしあれん	龍井蝦仁	名詞	
ろんじんしゃーれん	龍井蝦仁	名詞	
ろんじんちゃ	龍井茶	名詞	
ろんず	龍珠	名詞	
わかのむかし	若の昔	固有名詞	
わづかちゃ	和束茶	名詞	
ちーくーたん	奇古堂	名詞	台湾の有名な茶店
きっこどう	奇古堂	名詞	ちーくーたん
きこどう	奇古堂	名詞	ちーくーたん
