おおいわせ	おおいわせ	固有名詞	
おくひかり	おくひかり	固有名詞	
おくみどり	おくみどり	固有名詞	
おくゆたか	おくゆたか	固有名詞	
おまっちゃ	おまっちゃ	固有名詞	
かなやみどり	かなやみどり	固有名詞	
かんぼじあしゅ	カンボジア種	名詞	
きらか	きら香	固有名詞	
くりたわせ	くりたわせ	固有名詞	
さいのみどり	さいのみどり	固有名詞	
さえみどり	さえみどり	固有名詞	
さがらかおり	さがらかおり	固有名詞	
さがらひかり	さがらひかり	固有名詞	
さがらみどり	さがらみどり	固有名詞	
さがらわせ	さがらわせ	固有名詞	
さきみどり	さきみどり	固有名詞	
さとうわせ	さとう早生	固有名詞	
さみどり	さみどり	固有名詞	
さやまかおり	さやまかおり	固有名詞	
さやまみどり	さやまみどり	固有名詞	
さわみずか	さわみずか	固有名詞	
そうふう	そうふう	固有名詞	
そよぎ	そよぎ	固有名詞	
たかちほ	たかちほ	固有名詞	
たかねわせ	たかねわせ	固有名詞	
はるみどり	はるみどり	固有名詞	
はるもえぎ	はるもえぎ	固有名詞	
ひめみどり	ひめみどり	固有名詞
びるましゅ	ビルマ種	名詞	
ふうしゅん	ふうしゅん	固有名詞	
ふくみどり	ふくみどり	固有名詞	
べにふうき	べにふうき	固有名詞	
ほくめい	ほくめい	固有名詞	
みえうえじま	みえうえじま	固有名詞	
みどりのほし	みどりの星	固有名詞	
みなみかおり	みなみかおり	固有名詞	
みなみさやか	みなみさやか	固有名詞	
みねかおり	みねかおり	固有名詞	
みねゆたか	みねゆたか	固有名詞	
みやまかおり	みやまかおり	固有名詞	
むさしかおり	むさしかおり	固有名詞	
めいりょく	めいりょく	固有名詞	
やぶきた	やぶきた	固有名詞	
やまとみどり	やまとみどり	固有名詞	
やまなみ	やまなみ	固有名詞	
ゆたかみどり	ゆたかみどり	固有名詞	
りょうふう	りょうふう	固有名詞	
