ぴれんぜぴん	ピレンゼピン	名詞	M1選択的遮断薬。ガストール主成分
いぶ	EVE	名詞	イブプロフェン製剤
ぼるたれん	ボルタレン	名詞	ジクロフェナク製剤
がすとーる	ガストール	名詞	ピレンゼピン製剤
わかんせん	和漢箋	名詞	ロート製薬
ろきそにん	ロキソニン	名詞	ロキソプロフェン製剤
どっかつ	独活	名詞	漢方
かっこんとう	葛根湯	名詞	漢方
ようめいしゅ	養命酒	名詞	漢方
かっこん	葛根	名詞	漢方
けいひ	桂皮	名詞	漢方
しゃくやく	芍薬	名詞	漢方
まおう	麻黄	名詞	漢方
しょうきょう	生姜	名詞	漢方
じおう	地黄	名詞	漢方
たいそう	大棗	名詞	漢方
かんぞう	甘草	名詞	漢方
ろきそぷろふぇん	ロキソプロフェン	名詞	鎮痛剤
いぶぷろふぇん	イブプロフェン	名詞	鎮痛剤
じくろふぇなく	ジクロフェナク	名詞	鎮痛剤
りゅうかくさん	龍角散	名刺	鎮咳薬

