あくろきょうてき	悪路凶敵	名詞	
あんこんきょうかい	安魂教会	名詞	吾れ先導者たらん
いー	易	人名	
いーよ	易与	名詞	
いかく	異格	名詞	
いきょう	異境	名詞	
いきょうのいりぐち	異境の入口	名詞	
いどうとし	移動都市	名詞	
いよ	易与	名詞	
いんし	寅詩	名詞	
いんせい	引星	名詞	
いんちょうぼく	隠蝶墨	名詞	
うし	雨師	名詞	将進酒
うじゅう	羽獣	名詞	
うんがてい	雲瓦亭	名詞	
うんりょうしゅ	雲遼酒	名詞	将進酒
うんれつ	雲裂	名詞	
えいし	衛士	名詞	
えーしぇんつ	先民	名詞	
えきよ	易与	名詞	
えんえい	焔影	人名	
えんえいりーど	焔影リード	人名	
えんえんたるしょくどう	蜿蜒たる蜀道	名詞	
えんこく	炎国	地名	
えんごく	炎獄	名詞	
えんじゅ	槐	名詞	春分
えんび	焔尾	人名	
えんびきし	焔尾騎士	人名	
おうてつ	黄鉄	名詞	
おうてつのきょうこく	黄鉄の峡谷	地名	
おうほうろ	応峰路	名詞	将進酒
おおごと	瑟	名詞	
おたからひょうたん	お宝ひょうたん	名詞	
おとがい	顎	名詞	将進酒
おりじにうむ	源石	名詞	
おりぱしー	鉱石病	名詞	
おんちょうぼく	隠蝶墨	名詞	
かい	晦	名詞	画中人の黒いの
かいえんしい	界園志異	名詞	
かいこう	恢弘	名詞	導灯の試練
かいごう	灰毫	人名	
かいごうきし	灰毫騎士	人名	
かいこうしれん	恢弘試練	名詞	導灯の試練
かいしょく	亥食	名詞	
かいしょり	懐黍離	名詞	
がいそうじゅう	鎧爪獣	名詞	モンハンコラボ
かいそうひろく	回想秘録	名詞	
かいふくたて	回復盾	名詞	
かいめいそうこく	晦明相克	名詞	画中人
かいめいのいん	晦明の印	名詞	画中人
かいめいのしるし	晦明の印	名詞	画中人
かぎなわし	鉤縄師	名詞	
かくさく	画策	名詞	
かさねてさけをすすみ	重ねて酒を進み	名詞	
かしわう	柏生	名詞	モンハンコラボ
かせん	花銭	名詞	
がちゅうじん	画中人	名詞	画中人
からん	禍乱	名詞	
かんそくし	緩速師	名詞	
かんぼう	寒芒	名詞	
きき	器鬼	名詞	
きこうろうしゅ	帰行老酒	名詞	将進酒
きじ	奇事	名詞	
きみょうなひょうたん	奇妙なひょうたん	名詞	
きめい	帰溟	名詞	
きゃくさん	客桟	名詞	将進酒
きゅうていしんし	宮廷信使	名詞	将進酒
きょうしんきょうぎ	協心競技	名詞	
きょうふうのさげん	狂風の砂原	地名	
ぎょうゆう	行裕	名詞	将進酒
きょうれきしょうぜん	驚靂蕭然	名詞	12章
きょきさん	居奇山	地名	将進酒
ぎょくもん	玉門	地名	
きをとる	棋を執る	名詞	
きんきゅうさくせん	緊急作戦	名詞	
きんてんかん	欽天監	名詞	将進酒
きんてんし	靳天師	名詞	
ぎんゆうしゃ	吟遊者	名詞	
ぐうせん	遇戰	名詞	
くもとうるし	雲と漆	名詞	
くろみの	黒簑	名詞	
ぐんこう	群攻	名詞	
くんしゃく	勛爵	名詞	ウルサスの子供たち
ぐんゆし	群癒師	名詞	
げいきゃく	迎客	名詞	
げいきゃくにゅうえん	迎客入園	名詞	
けいこう	軽功	名詞	将進酒
けつじょう	血掟	名詞	
けつじょうてきさす	血掟テキサス	人名	
けんう	剣雨	名詞	
げんがん	源岩	名詞	
げんがんこう	源岩鉱	名詞	
けんじし	見字祠	名詞	
けんじょうほうしゅ	堅城砲手	名詞	
げんせき	源石	名詞	
げんせきすい	源石錐	名詞	
こう	功	名詞	将進酒
こうご	句呉	地名	
こうごじょう	句呉城	名詞	将進酒
こうせきびょう	鉱石病	名詞	
こうせん	衡銭	名詞	
こうみょうらいらく	光明磊落	名詞	将進酒
こうりくろう	洪陸楼	名詞	
こくさい	黒簑	名詞	
こくはくにゅうげん	黒白入玄	名詞	
ここんがくしき	古今学識	名詞	
こし	古肆	名詞	
ごしょう	午商	名詞	
こしょうしゅ	湖松酒	名詞	将進酒
こせい	孤星	名詞	
ごぼう	丑謀	名詞	
ごぼうかく	五紡閣	名詞	将進酒
ごをとる	棋を執る	名詞	
こんたんほう	昏譚峰	地名	将進酒
さいう	淬羽	名詞	異格サイレンス
さいうさいれんす	淬羽サイレンス	名詞	異格サイレンス
さいく	歳躯	名詞	
さいじ	歳時	名詞	
さいじゅう	歳獣	名詞	
さいじゅうのざんしき	歳獣の残識	名詞	
さが	嵯峨	人名	
さかつ	茶歇	名詞	
さげん	砂原	地名	
ざつぎ	雑疑	名詞	
さつこうほう	攥江峰	名詞	将進酒
さんかいしゅう	山海衆	名詞	
さんけついち	三缺一	名詞	
ざんごう	斬業	名詞	
ざんごうほしぐま	斬業ホシグマ	名詞	
さんざんじゅうしちほう	三山十七峰	名詞	将進酒
さんざんじゅうはちほう	三山十八峰	名詞	将進酒
ざんしき	残識	名詞	
さんすいかく	山水閣	名詞	
しうんほう	梓雲峰	地名	将進酒
しぇん	慎	人名	将進酒
しえん	熾炎	名詞	
しぇんろう	慎楼	人名	将進酒
しごうきん	熾合金	名詞	
しざい	試剤	名詞	
しさいだい	司歳台	名詞	将進酒
じじゅう	似獣	名詞	
ししょくきゃく	伺燭客	名詞	
じしょくにん	持燭人	名詞	将進酒
してい	司霆	名詞	
していしれん	指定試練	名詞	導灯の試練
していれいず	司霆レイズ	名詞	
しのう	巳農	名詞	
しほん	四品	名詞	将進酒
しまつりょう	始末陵	名詞	
しむ	子武	名詞	
しゃさんこじ	煮傘居士	人名	画中人
しゅいんとくか	種因得果	名詞	
しゅうい	拾遺	名詞	
じゅうしゅ	獣主	名詞	
じゅうじゅん	重盾	名詞	
じゅうじゅんえいし	重盾衛士	名詞	
じゅうにほん	従二品	名詞	将進酒
しゅくせいいん	粛清院	名詞	将進酒
しゅこうほう	取江峰	地名	将進酒
じゅつえ	戌絵	名詞	
じゅつせんし	術戦士	名詞	
じゅゆし	呪癒師	名詞	
じゅんじん	純燼	名詞	
じょうか	滌火	名詞	異格ジェシカ
じょうかじぇしか	滌火ジェシカ	名詞	異格ジェシカ
しょうき	承曦	人名	
しょうぎ	承曦	人名	
しょうしゅうけん	招集券	名詞	
しょうしょ	尚書	名詞	将進酒
しょうしょく	尚蜀	地名	将進酒
しょうしょく	錆色	名詞	
じょうらく	常楽	名詞	
しょくか	燭火	名詞	
しょくかのみちびき	燭火の導き	名詞	
しょくどう	蜀道	名詞	
じょごもん	汝吾門	名詞	
じんかん	人間	名詞	将進酒
しんぎんざん	真銀斬	名詞	
じんじつほう	尋日峰	地名	将進酒
しんちゅう	申鋳	名詞	
しんと	新砥	名詞	
しんみん	神民	名詞	
しんめい	深溟	名詞	
しんらんく	新巒区	地名	将進酒
しんろう	真狼	名詞	
すいげき	推撃	名詞	
すいげきしゅ	推撃手	名詞	
すいばく	睡爆	名詞	
すいぼつちょうくつ	水没潮窟	名詞	
すうしゅうほう	数舟峰	名詞	将進酒
ずお	左	人名	将進酒
ずおらう	左楽	人名	将進酒
せいかんじゅうこう	星環重工	名詞	
せいしょく	錆色	名詞	
せいどう	錆銅	名詞	
せいらいはく	青雷伯	名詞	将進酒
せいらんほう	青鑾峰	地名	将進酒
せいりょう	青嶺	名詞	
せきしょう	赤霄	名詞	
ぜにばこ	銭匣	名詞	
ぜひきょう	是非境	名詞	
せんこう	銭匣	名詞	
せんしょう	千嶂	名詞	
せんしょうのへんさい	千嶂の辺塞	名詞	
せんみん	先民	名詞	
そうき	操機	名詞	
そうこう	崢嶸	名詞	将進酒
そうさんと	争山渡	名詞	将進酒
そうどう	相道	名詞	
そうぼさんち	蒼暮山地	名詞	モンハンコラボ
そうゆう	礎烏有	人名	将進酒
そかくそう	阻隔層	名詞	
そじゅう	鼷獣	名詞	
ぞんご	存護	名詞	
だいいちそう	第壱層	名詞	
だいえんつうほう	大炎通宝	名詞	
だいごそう	第伍層	名詞	
だいさんそう	第参層	名詞	
だいじょうふ	大丈夫	名詞	将進酒
だいにそう	第弐層	名詞	
たいほー	太合	人名	将進酒
だいよんそう	第肆層	名詞	
だいりじしょうけい	大理寺少卿	名詞	将進酒
だいれいそう	第零層	名詞	
だいろくそう	第陸層	名詞	
たくじん	濯塵	人名	
だくしん	濁心	名詞	
たくぢん	濯塵	人名	
たんぷ	担夫	名詞	将進酒
ちゃーふう	茶壺	名詞	将進酒
ちょうぞうきき	彫像器鬼	名詞	
ちょうへんざんこん	長篇残痕	名詞	
ちょんゆえ	重岳	名詞	
ちんぎんざん	賃金斬	名詞	
ちんぎんざん	輝かざる栄光	名詞	
ちんぶのぎ	鎮撫之儀	名詞	
つうほう	通宝	名詞	
つゆはなむら	露華村	名詞	モンハンコラボ
てい	鄭	人名	将進酒
ていじゅう	諦獣	名詞	
ていちんゆえ	鄭清鉞	名詞	将進酒
でいでいほう	泥泥峰	地名	将進酒
できか	滌火	名詞	異格ジェシカ
できかじぇしか	滌火ジェシカ	名詞	異格ジェシカ
てきちゆうせい	掷地有声	名詞	
てつのひょうたん	鉄のひょうたん	名詞	
てんがく	天岳	地名	将進酒
でんせつ	伝説	名詞	
てんどう	天瞠	名詞	
どぅ	杜	姓	将進酒
とうげん	糖源	名詞	
どうとう	導灯	名詞	導灯の試練
どうとうのしれん	導灯の試練	名詞	導灯の試練
どぅやおいぇ	杜遥夜	人名	将進酒
とうりんい	登臨意	名詞	
にゅうげん	入幻	名詞	
にょさい	如歲	名詞	
にれのちょう	楡の蝶	名詞	
にん	寧	人名	将進酒
にんつーーちう	寧辞秋	人名	将進酒
ねっさひぶん	熱砂秘聞	名詞	
ばいでぃんしゃん	白定山	名詞	将進酒
ばんしょうついおくろく	万象追憶録	名詞	
ひごえいし	庇護衛士	名詞	
ひしょせい	皮書生	名詞	
ひぼう	牌坊	名詞	将進酒
ひょうきょく	鏢局	名詞	将進酒
ひょうし	鏢師	名詞	将進酒
ひょうじゅんしれん	標準試練	名詞	導灯の試練
ひょうとう	鏢頭	名詞	将進酒
ふかい	浮海	名詞	
ふくかんさつぎょし	副観察御史	名詞	将進酒
ぶつてん	勿玷	名詞	懐黍離
ふへいうし	浮萍雨師	名詞	将進酒
ふりせん	振り銭	名詞	
へいけんきゃく	平剣客	名詞	
へいさい	秉燭	名詞	
へいすいこう	平祟候	名詞	将進酒
べつりほう	別離峰	地名	将進酒
へんさい	辺塞	名詞	
べんぷ	便符	名詞	
ぼうあい	芒鞋	名詞	春分
ぼうさん	邙山	名詞	
ぼうさんちょう	邙山町	名詞	
ぼうさんちょうきょうどし	邙山町郷土誌	名詞	
ほうしとっぱ	鋒矢突破	名詞	
ぼうすいへい	忘水坪	地名	将進酒
ほうもうかいかい	法網恢恢	名詞	将進酒
ぼうりつ	卯律	名詞	
ぼくか	墨化	名詞	
ぼくかのざんひ	墨化の残碑	名詞	
ぼくりょう	墨魎	名詞	
まおしゅえわん	毛血旺	名詞	将進酒
まなじり	睚	人名	
みけん	未建	名詞	
みちょうく	未長区	名詞	将進酒
むそうようらん	夢想揺藍	名詞	
むちゅうめい	00	名詞	
めい	明	名詞	画中人の白いの
もうりょう	罔両	名詞	将進酒
もんすたー	Mon3tr	名詞	
もんそうかく	問霜客	名詞	将進酒
やそう	野鬃	名詞	
やそうきし	野鬃騎士	名詞	
やぞうぼう	治造坊	名詞	春分
ゆいめん	玉門	地名	
ゆうこうのやけい	幽光の夜警	名詞	吾れ先導者たらん
ゆうりゅう	遊龍	名詞	
ようきし	耀騎士	名詞	
らくてい	落蹄	地名	
らくていしゅう	落蹄州	地名	
りゃん	梁	人名	将進酒
りゃんしゅん	梁洵	人名	将進酒
りゅうある	劉二	人名	将進酒
りゅううんく	流雲区	地名	将進酒
りんちんいぇん	麟青硯	名詞	将進酒
れいせん	厲銭	名詞	
れいでぃあん	レイディアン	人名	
れいぶ	礼部	名詞	将進酒
れいぶさじろう	礼部左侍郎	名詞	将進酒
れんげきし	鎌撃士	名詞	
れんさゆし	連鎖癒師	名詞	
ろうしゅ	狼主	名詞	
ろどす	ロドス	名詞	
ろへんきだん	炉辺奇談	名詞	
ろんめん	龍門	地名	
ろんめんへい	龍門幣	名詞	
わらいておおごとをこせ	笑いて瑟を鼓せ	名詞	
