あけとん	アケトン	名詞	
あけとんふんまつ	アケトン粉末	名詞	
あぶりむし	アブリムシ	名詞	
あんげろす	アンゲロス	名詞	
あんげろみら	アンゲロミラ	名詞	
あんせき	闇石	名詞	
あんていたんかい	安定炭塊	名詞	
あんないちょう	案内蝶	名詞	
あんないとう	案内灯	名詞	
いゔぉんぬ	イヴォンヌ	人名	
いぇるしぇ	イェルシェ	地名	
いこうせき	異香石	名詞	
いじょうかいだん	異常階段	名詞	
いりょうとう	医療塔	名詞	
うごくはすのは	動く蓮の葉	名詞	
うすべにたけ	薄紅茸	名詞	
うんぱんそうさたんまつ	運搬操作端末	名詞	
えいよう	鋭葉	名詞	
えきたいちっそとう	液体窒素塔	名詞	
えだおりじむし	枝オリジムシ	名詞	
えんどふぃーるど	エンドフィールド	名詞	
おーりれん	オーリレン	名詞	
おーりれんかめら	オーリレンカメラ	名詞	
おりじむし	オリジムシ	名詞	
おんぱとう	音波塔	名詞	
かえいきょうか	火映蕎花	名詞	
かがくはんのうろ	化学反応炉	名詞	
かくちょうえんざんちっぷ	拡張演算チップ	名詞	
かくらんち	撹乱値	名詞	
がじゅう	牙獣	名詞	
がしん	芽針	名詞	
かぜのうず	風の渦	名詞	
かどうぼーど	可動ボード	名詞	
かねんげる	可燃ゲル	名詞	
かんじゅう	鉗獣	名詞	
かんりにん	管理人	人名	
きしつしょくこく	基質食刻	名詞	
きしつしょっこく	基質食刻	名詞	
きそかくちょうこあ	基礎拡張核心	名詞	
きゅうしじゅう	球刺獣	名詞	
きゅうでんたんまつ	給電端末	名詞	
きょうか	蕎花	名詞	
きょうかさいふん	蕎花細粉	名詞	
きょうもう	凶猛	名詞	
きょうやく	協約	名詞	
きょうやくかくちゅう	協約角柱	名詞	
きょうやくくうかん	協約空間	名詞	
きょうやくこあ	協約核心	名詞	
きょうやくちょぞうばこ	協約貯蔵箱	名詞	
きょうやくでぃすく	協約ディスク	名詞	
きょうやくてんそう	協約転送	名詞	
きょうやくようりょう	協約容量	名詞	
きょかく	巨角	名詞	
ぎよく	擬翼	名詞	
きんそう	錦草	名詞	
くようしょう	苦畑椒	名詞	
けいあんせき	軽闇石	名詞	
けいこくとうえい	警告投影	名詞	
けっしょうえいよう	結晶鋭葉	名詞	
けっしょうがいかく	結晶外殻	名詞	
けっしょうたけ	血潮茸	名詞	
げんせき	源石	名詞	
げんせきかいろ	源石回路	名詞	
げんせきふんまつ	源石回路	名詞	
こあ	核心	名詞	
こうかいん	宏科院	名詞	
ごうかく	剛角	名詞	
こうぎょうばくだん	工業爆弾	名詞	
こうざん	宏山	地名	
こうざんかがくいん	宏山科学院	名詞	
こうじゅう	咬獣	名詞	
こうじゅう	甲獣	名詞	
こうしょう	高晶	名詞	
こうじょうしゃのがんとれっと	攻城者のガントレット	名詞	
こうしょうせいぼとる	高晶製ボトル	名詞	
こうしょうせんい	高晶繊維	名詞	
こうしょうそうびぶひん	高晶装備部品	名詞	
こうしょうぶひん	高晶部品	名詞	
こうしょうふんまつ	高晶粉末	名詞	
こうしょくたけ	紅色茸	名詞	
こうせいぶひん	鋼製部品	名詞	
こうせいぼとる	鋼製ボトル	名詞	
こうせんとう	光線塔	名詞	
こうみつどけっしょうふんまつ	高密度結晶粉末	名詞	
こうみつどげんせきふんまつ	高密度源石粉末	名詞	
こうみつどせいてつふんまつ	高密度青鉄粉末	名詞	
こうみつどたんかいふんまつ	高密度炭塊粉末	名詞	
こくぎんしとろーむ	黒銀シトローム	名詞	
こっさい	骨砕	名詞	
こなくず	粉屑	名詞	
さいふん	細粉	名詞	
さんどりーふ	サンドリーフ	名詞	
さんどりーふふんまつ	サンドリーフ粉末	名詞	
しがしん	茨芽針	名詞	
しじゅう	刺獣	名詞	
ししょう	紫晶	名詞	
ししょうせいぼとる	紫晶製ボトル	名詞	
ししょうせんい	紫晶繊維	名詞	
ししょうそうびぶひん	紫晶装備部品	名詞	
ししょうぶひん	紫晶部品	名詞	
ししょうふんまつ	紫晶粉末	名詞	
じっぷらいん	ジップライン	名詞	
しとろーむ	シトローム	名詞	
しとろーむさいふん	シトローム細粉	名詞	
じゅうあんせき	重闇石	名詞	
しゅうげき	終撃	名詞	
じゅうこうげき	重攻撃	名詞	
しゅうせいこうぎょう	集成工業	名詞	
しゅうせいこうぎょうしすてむ	集成工業システム	名詞	
じゅうどちょういきかっせいてん	重度超域活性点	名詞	
じゅうにく	獣肉	名詞	
しゅうほうどう	集宝洞	名詞	
しゅどうかいにゅう	主動介入	名詞	
じゅんしょうえいよう	純晶鋭葉	名詞	
じゅんすい	潤水	名詞	
じゅんすいぶろっく	潤水ブロック	名詞	
しょうかいとう	哨戒塔	名詞	
しょうけんこう	小剣杭	名詞	
しょくこく	食刻	名詞	
しょくでん	蝕電	名詞	
しょっこく	食刻	名詞	
しんし	針刺	名詞	
しんむのくろすぼう	侵霧のクロスボウ	名詞	
すいしょう	錐晶	名詞	
すいとうちゅう	水灯虫	名詞	
すきゃんたんち	スキャン探知	名詞	
せいてつ	青鉄	名詞	
せいてつせいぼとる	青鉄製ボトル	名詞	
せいてつそうびぶひん	青鉄装備部品	名詞	
せいてつふんまつ	青鉄粉末	名詞	
せいはとりで	清波砦	名詞	
せいもんぱずる	星門パズル	名詞	
せっかい	石塊	名詞	
せんぎ	戦技	名詞	
せんち	潜地	名詞	
そうこちゅうけいぼっくす	倉庫中継ボックス	名詞	
そうし	槍刺	名詞	
そうぞく	滄賊	名詞	
そくじょう	息壌	名詞	
そくじょうきょう	息壌橋	名詞	
そんぞくのこんせき	存続の痕跡	名詞	
だびさん	駄鼻山	名詞	
たんかい	炭塊	名詞	
たんかいふんまつ	炭塊粉末	名詞	
ちいきかんてんそう	地域間転送	名詞	
ちいきそうこ	地域倉庫	名詞	
ちゅうあんせき	中闇石	名詞	
ちゅうにく	虫肉	名詞	
ちゆかく	治癒核	名詞	
ちょういき	超域	名詞	
ちょういきかっせいてん	超域活性点	名詞	
ちょうきょりじっぷらいん	長距離ジップライン	名詞	
ちょうしん	潮進	名詞	
ちょうせきしょうせき	潮汐晶石	名詞	
ちんでんしょうせき	沈殿晶石	名詞	
ちんでんぶっぴん	沈殿物品	名詞	
つうじょうこうげき	通常攻撃	名詞	
でぃーじゃんごう	帝江号	名詞	
でぃーじゃんごう	O.M.V.帝江号	名詞	
てつせいぶひん	鉄製部品	名詞	
でんごんびーこん	伝言ビーコン	名詞	
てんのうはら	天王原	地名	
でんりゅうとう	電流塔	名詞	
どうてきしんしょく	動的侵蝕	名詞	
とくせいけっしょう	特製結晶	名詞	
とりあんげろす	トリアンゲロス	名詞	
ながあしじゅう	長足獣	名詞	
ながあしじゅうはいたつ	長足獣配達	名詞	
ながみみじゅう	長耳獣	名詞	
にがばしょう	苦葉椒	名詞	
ねつでんとうぎたいせき	熱伝導擬態石	名詞	
ねつむ	熱霧	名詞	
はいむぎ	灰麦	名詞	
はくこうたけ	薄紅茸	名詞	
ばんじゅう	蟠獣	名詞	
ひっさつわざ	必殺技	名詞	
ふこうじゅう	斧甲獣	名詞	
ふこうじゅうのつの	斧甲獣の角	名詞	
ふゆうばこ	浮遊箱	名詞	
ぶりょう	武陵	地名	
ぶりょうとりひきけん	武陵取引券	名詞	
ぶれいくち	ブレイク値	名詞	
ぶれいくてん	ブレイク点	名詞	
ふんせつ	粉屑	名詞	
べにいろたけ	紅色茸	名詞	
ぺりか	ペリカ	人名	
ほうさいのおの	崩砕の斧	名詞	
ぽぐらにちにく	ポグラニチニク	人名	
ほこうしょうじょう	歩行晶城	名詞	
ほたるむし	ホタルムシ	名詞	
むか	霧火	名詞	
めいそうりん	迷躁林	名詞	
もぎくうかん	模擬空間	名詞	
やちとりひきけん	谷地取引券	名詞	
ゆうこく	幽谷	名詞	
よんごうやち	四号谷地	名詞	
りょうきょう	稜鏡	地名	
りょうてきとう	菱摘島	地名	
りんじちょういきかっせいてん	臨時超域活性点	名詞	
りんじゅう	鱗獣	名詞	
れんけいわざ	連携技	名詞	
